LunYuCunZhuang.	['轮雨村庄', '轮雨村庄之禁忌游戏', '轮雨村庄(天鹅湾店)怎么样']
AppleStore	['app了store', 'app了store无法连接怎么办', 'app了store验证码老是白的', 'app了store无法登录', 'apple store怎么改成中文', 'app了store是什么意思', 'apple store自动扣费', 'apple store无法下载', 'apple store无法连接', 'app了store打不开']
vika1	['vikasu', 'vikar', 'vikan', 'vikar乳胶枕好不好', 'vikar泰国乳胶枕', 'vikar私护的功效', 'vika是什么意思', 'vikacg下载', 'vikas']
UYOUNG	['u有哪些发音']
ChateauStarRiver	['chateaustarriver.com']
青年公社	['青年公寓', '青年公寓租房', '青年公社', '青年公园', '青年公社餐厅', '青年公寓是什么意思', '青年公园地铁站', '青年公寓调研报告', '青年公寓租房的坏处', '青年公社餐厅王四营']
QianZiLian-2	['千子莲足道', '千子莲足道有飞机吗', '千子莲', '嵌字联', '钱自亮', '钱字亮', '倩字连笔签名设计', '倩字连笔签名', '千子莲足疗会所怎么样', '千子莲珠江帝景店足疗']
homeinns3	['homeinn什么意思']
Bankcomm	['bankcomm.com']
homeinns2	['homeinn什么意思', 'homeinn是什么意思']
TangGong	['唐宫仕女图', '唐宫海鲜舫', '唐宫原著', '唐功红七窍流血视频', '唐功红现如今生活', '唐宫美人天下', '唐功红', '唐宫', '唐宫小聚', '唐宫燕']
蝎王府	['蝎王府羊蝎子加盟费多少', '蝎王真舒服', '蝎王府羊蝎子店址', '蝎王府', '蝎王府外卖菜单', '蝎王药膏', '蝎王蜂毒', '蝎王漫威', '蝎王府羊蝎子', '蝎王风骨康']
chaoyangjianshen	['朝阳建设集团有限公司', '朝阳建设银行', '朝阳建设银行电话', '潮阳建设银行电话', '朝阳建设', '潮阳建设银行网点', '朝阳建设银行网点', '朝阳建设集团', '朝阳健生养老院', '朝阳建设银行支行电话']
眉州东坡酒楼	['眉州东坡酒楼顺义店', '眉州东坡酒楼亦庄店', '眉州东坡酒楼订餐电话', '眉州东坡酒楼长虹桥', '眉州东坡酒楼电话', '眉州东坡酒楼魏公村店', '眉州东坡酒楼草桥电话', '眉州东坡酒楼', '眉州东坡酒楼菜单', '眉州东坡酒楼官网']
jazz.ya	['jazzy是什么意思中文翻译', 'jazzy歌手', 'jazz音乐', 'jazz音标', 'jazz英文', 'jazz音响是哪里产', 'jazz用英语怎么读', 'jazz英文怎么读音', 'jazz音乐的特点', 'jazz音箱']
AMBER	['amber', 'amber是什么意思中文', 'amber room', 'amber alert', 'amber英文名寓意', 'ambergris', 'ambee', 'amber label', 'amber怎么读', 'amber heard现任男友']
眉州东坡-12	['眉州东坡15人', '眉州东坡18岁成人礼', '眉州东坡10元代金券', '眉州东坡1的无线网络密码是多少', '眉州东坡1+11经典菜品', '眉州东坡18岁成人礼视频']
rujia	['乳交', '乳胶漆', '如家', '乳胶', '儒家', '乳胶枕', '乳胶床垫', '如家酒店', '如胶似漆', '如饥似渴']
太平洋咖啡	['太平洋咖啡', '太平洋咖啡官网', '太平洋咖啡星冰乐', '太平洋咖啡加盟', '太平洋咖啡菜单', '太平洋咖啡怎么样', '太平洋咖啡 贵妃气泡', '太平洋咖啡营业时间', '太平洋咖啡云朵妹妹', '太平洋咖啡厅']
YFJAZZ	['衣服架安装图片大全', '引风机安装标准', '引风机安装']
CMCC-WEB	['cmccweb免费帐号', 'cmccweb登录界面', 'cmccweb怎么连接', 'cmccweb免费账号密码', 'cmccwed', 'cmccweb怎么连不上', 'cmccweb是什么网络', 'cmccweb', 'cmccweb收费吗', 'cmccweb怎么免费连接']
100inn	['100inch等于多少厘米', '100inn的wifi密码', '100inch等于多少米', '100inch', '100inn']
qianzilianzudao	['千子莲足道', '千子莲足道有飞机吗', '千子莲足道消费价格', '千子莲足道怎么样', '千姿莲足道', '千子莲足道(金牛街荷塘月色店)怎么样', '千子莲足道(亦庄分店)怎么样', '千子莲足道有小姐吗', '千子莲足道(木樨园店)怎么样', '千子莲足道(西矿街店)怎么样']
HUAZHU-Hanting	['华住汉庭的密码是什么', '华住汉庭', '华住汉庭宁波', '华住汉庭酒店wifi密码', '华住汉庭索菲亚', '华住汉庭酒店数据泄漏', '华住汉庭电话是多少', '华住汉庭wifi密码认证', '华住汉庭酒店', '华住汉庭官网']
misshuo	['miss虎牙', 'miss化妆品', 'miss换脸史', 'miss黄金周 可爱', 'miss化妆品是什么牌子', 'miss黄金周的果实', 'miss护肤品微商', 'miss胡', 'miss黄金周高清图']
tianehui	['天鹅湖', '天鹅湖芭蕾舞', '天鹅湖万达', '天鹅湖花园', '天鹅湖大酒店', '天鹅湖故事', '天鹅湖在哪里', '天鹅湖作者', '天鹅湖景区', '天鹅湖草原']
HI辣火锅	['hi辣火锅', 'hi辣火锅创始人', 'hi辣火锅邓家佳官网', 'hi辣火锅在哪些城市', 'hi辣火锅价目表', 'hi辣火锅店加盟', 'hi辣火锅地址', 'hi辣火锅加盟费', 'hi辣火锅北京地址', 'hi辣火锅地址上海']
24小时自助图书馆	['24小时自助图书馆(大东门街分馆)怎么样', '24小时自助图书馆退卡', '24小时自助图书机', '24小时自助图书馆书籍多吗', '24小时自助图书馆加盟', '24小时自助图书馆 评论', '24小时自助图书馆', '24小时自助图书馆费用', '24小时自助图书馆怎么使用']
CMCC	['cmc公司', 'cmcc', '重名查询', 'cmc值', 'cmcb', 'cmcc是什么网络', 'cmc资本', 'cmcc的wifi密码是多少']
chongqingxiaomian	['重庆小面', '重庆小面的做法', '重庆小面加盟店', '重庆小面的做法及配料', '重庆小面图片', '重庆小面培训哪家最好', '重庆小面加盟费多少钱', '重庆小面加盟要多少钱']
jinshoushao	['金手勺', '金寿山', '金手勺东北菜', '筋受伤了怎么治疗', '筋受伤恢复要多久', '金手勺电话', '筋受伤了吃什么好得快', '金手勺菜单', '筋受伤用什么药最好', '金手勺海鲜大咖']
shishangmatou	['时尚码头全国连锁店', '时尚码头', '时尚码头美容美发', '时尚码头北京连锁店', '时尚码头姚金虎董事长', '时尚码头姚金虎', '时尚码头东坝店', '时尚码头美容院怎么样', '时尚码头商学院怎么样', '时尚码头宋家庄电话']
LunYuCunZhuang2	['轮雨村庄', '轮雨村庄之禁忌游戏', '轮雨村庄(天鹅湾店)怎么样']
ziroom	['ziroom', '自如租房', 'ziroom自如', 'ziroom默认wifi密码', '自如内网', '自如租房怎么样', '自如客服电话', '自如租房靠谱吗', '自如内网登录', '自如电话']
QianZiLian-1	['千子莲足道', '千子莲足道有飞机吗', '千子莲', '嵌字联', '钱自亮', '钱字亮', '倩字连笔签名设计', '倩字连笔签名', '千子莲足疗会所怎么样', '千子莲珠江帝景店足疗']
PizzaHut	['pizza黄游', 'pizza火币', 'pizza黄游戏']
ZTYY	['詹天佑', '赵天宇', '止痛药', '中田英寿', '张廷玉', '中铁一局', '种太阳', '中铁一局五公司', '章太炎', '周庭伊']
LunYuCunZhuang3	['轮雨村庄', '轮雨村庄之禁忌游戏', '轮雨村庄(天鹅湾店)怎么样']
棉花酒铺	['棉花酒精塞耳朵', '棉花酒吧 上海']
@全羊肉泡馍	['全羊肉泡馍(青年路总店)怎么样', '全羊肉泡馍(青年路总店)']
.@博成雅居酒楼	['博成雅居酒楼', '博成雅居酒楼团购美团', '博成雅居酒楼(青年路店)', '博成雅居酒楼(朝外店)怎么样']
MOBE	['mobile phone', '墨宝非宝', 'mobility', '莫泊桑', '膜拜', 'mobike', 'moba', 'moba游戏', 'mobil', 'mobi']
huaniucanguan	['花牛餐馆', '花牛餐馆(国美店)怎么样', '花牛餐馆在北京有几家店', '花牛餐馆(国美店)', '花牛餐馆什么菜单', '花牛餐馆十里铺店', '花牛餐馆什么菜系']
有一串吧	['有一串数1 1 2 3 5 8', '有一串分数按如下规律排列:1/2,1/3,2/3', '有一串彩珠按2红3绿4黄', '有一串数5,8,13,21', '有一串英文字母的车标', '有一串字母的是什么车', '有一串数字按如下排列', '有一串串铜钱一样的树', '有一串珠子共80颗', '有一串28颗的珠子']
WX-QJD	['无线桥接怎么设置', '无线桥接', '危险期计算', '微信群禁言怎么设置', '微信群禁言', '王小骞简介', '微信群机器人', '微信群机器人怎么弄的', '无线桥接是什么意思', '无线桥接路由器']
runjiangnan2	['润江南', '润江南朝阳大悦城店', '润江南旅行社', '润江南旅行社怎么样', '润江南 订餐 电话', '润江南倒闭', '润江南热水器', '润江南热水器怎么安装', '润江南餐厅怎么样']
LianJia	['脸基尼', '联机游戏', '脸颊', '链家网', '链接', '连江前天发生一起车祸', '链家', '炼金术', '廉晶雅', '连襟']
HEYTEA	['heytea喜茶 官网', 'heytea怎么读', 'heytec', 'heytea喜茶种类', 'heytea是什么意思', 'heytea喜茶加盟费大概多少', 'heytea加盟电话', 'heytea', 'heytea喜茶', 'heytea喜茶能加盟吗']
Starbucks	['星巴克']
bianlifeng	['便利蜂', '便利蜂加盟费多少', '便利蜂招聘', '便利蜂咖啡', '便利蜂官网', '便利蜂工资怎么那么高', '便利蜂连锁便利店', '便利蜂加盟费', '便利蜂加盟', '便利蜂app']
weishiguang	['胃食管反流', '胃食管反流病的症状', '胃食管反流吃什么药', '胃食管反流怎么冶', '胃食管反流能根治吗', '胃食管反流病怎么治', '胃食管反流的治疗', '胃食管反流病能治好吗', '胃食管反流病的症状吃什么药', '胃食管反流怎么检查']
Waipojia	['外婆家', '外婆家加盟费多少', '外婆家必点招牌菜', '外婆家菜单', '外婆家官网', '外婆家的澎湖湾', '外婆叫我接待客人画日本漫画', '外婆家是什么菜系', '外婆家餐厅', '外婆家吴国平']
祥艾堂	['祥艾科技有限公司']
西贝莜面村	['西贝莜面里什么菜好吃', '西贝莜面哪里的', '西贝莜面村让加盟吗', '西贝莜面怎么读', '西贝莜面村创始人', '西贝莜面事件', '西贝莜面村怎么念', '西贝莜面村12个必点菜', '西贝莜面村', '西贝莜面加盟费']
WAGAS	['wagas菜单', 'wagas', '哇嘎', '瓦岗寨', 'wagan', '瓦岗诺娃', 'wagon', 'wagashi', '哇嘎播放器', 'wagame']
sdt	['sds', '山东大学', 'sdk', 'sd卡', 'sd敢达', 'sdn', 'sex', '山东省教育招生考试院', '山东', 'sdr']
amber	['amber', 'amber是什么意思中文', 'amber room', 'amber alert', 'amber英文名寓意', 'ambergris', 'ambee', 'amber label', 'amber怎么读', 'amber heard现任男友']
BJLYFCYY	['北京俪婴妇产医院价格', '北京俪婴妇产医院人流', '北京丽婴妇产医院地址', '北京俪婴妇产医院电话', '北京俪婴妇产医院招聘', '北京六月份穿衣服图片', '北京丽婴妇产医院介绍', '北京俪婴妇产医院消费', '北京丽樱妇产医院']
runjiangnan	['润江南朝阳大悦城店', '润江南', '润江南旅行社', '润江南旅行社怎么样', '润江南 订餐 电话', '润江南热水器', '润江南倒闭', '润江南热水器安装', '润江南餐厅怎么样']
DiaoYeniunan	['雕爷牛腩', '雕爷牛腩失败的原因', '雕爷牛腩创始人', '雕爷牛腩现状', '雕爷牛腩菜单价目表', '雕爷牛腩西安店', '雕爷牛腩现状2019', '雕爷牛腩上海几家店', '雕爷牛腩老板', '雕爷牛腩外卖图片']
xianaohui	['西安奥辉纸厂', '西安奥华', '虾脑汇怎么样', '西安奥辉纸业', '西安奥华电子仪器', '西安奥华电子', '下脑火喝什么药好', '西安奥辉纸业张孝普']
BEERALL	['beerall']
招商银行	['招商银行电话', '招商银行卡', '招商银行信用卡电话', '招商银行网点', '招商银行信用卡', '招商银行', '招商银行app', '招商银行客服电话', '招商银行股票', '招商银行地址']
homeinns	['homeinn什么意思']
XuePankaochuan	['薛蟠烤串', '薛蟠烤串 张艺兴', '薛蟠烤串为什么叫薛蟠', '薛蟠烤串老板是谁', '薛蟠烤串官网', '薛蟠烤串(朝阳大悦城店)', '薛蟠烤串(蓝色港湾店)', '薛蟠烤串(朝阳大悦城店)网友评论', '薛蟠烤串是谁开的', '薛蟠烤串蓝色港湾电话']
yingpaisijianshen	['英派斯健身', '英派斯健身年卡价格表', '英派斯健身器材', '英派斯健身俱乐部', '英派斯健身价格', '英派斯健身电话', '英派斯健身怎么样', '英派斯健身器材价格', '英派斯健身官网', '英派斯健身新天地店']
xiaojungan	['小郡肝是什么', '小郡肝', '小郡肝串串香价格', '小郡肝串串香', '小郡肝串串香加盟费多少', '小郡肝串串', '小郡肝串串香加盟骗局', '萧军感情史', '小郡肝加盟费', '小君肝']
N27th	['女27头疼厉害']
32bar	['32bar', '32磅', '32磅等于多少斤', '32把锁推拿法', '32磅炮', '32磅等于多少人民币', '32bar是什么意思', '32拜视频', '32拜', '32磅弓用多大挠度的箭']
pinkbaby	['pink爸爸是什么牌子']
shunshun	['顺水推舟', '顺顺利利', '顺顺留学', '顺水人情', '顺顺', '顺水鱼馆', '顺遂', '顺水速度和逆水速度的公式', '顺顺电影', '顺数']
xiachixiashuan	['虾吃虾涮', '虾吃虾涮的做法', '虾吃虾涮加盟多少钱', '虾吃虾涮加盟', '虾吃虾涮虾火锅', '虾吃虾涮图片', '虾吃虾涮怎么样', '虾吃虾涮菜单', '虾吃虾涮地址', '虾吃虾涮虾火锅加盟费多少钱']
jazzya	['jazz是什么舞种', 'jazzy歌手', 'jazz音乐', 'jazz是什么意思中文翻译', 'jazzy30', 'jazzy是什么意思中文翻译', 'jazzy酒', 'jazz funk是什么舞种', 'jazz舞', 'jazzcat舞蹈考级视频']
3AM	['3a大作', '3a游戏', '3am', '3atv见字如见本站一区', '3ar', '3ce', '3c', '3a平台', '3a走势图带连线走势图带连线']
elephant1	['elephant 怎么读', 'elephant什么意思思', 'elephant是什么意思中文', 'elephant in the room', 'elephant什么意思', 'elephant的音标', 'elephant战队', 'elephant bird', 'elephant house', 'elephant seal']
shunshun2	['顺顺', '顺顺留学', '顺顺利利', '顺顺电影', '顺顺儿', '顺顺当当', '顺顺溜溜的意思', '顺顺利利图片', '顺顺利利的数字红包', '顺顺丰快递单号查询']
hanjimmy	['焊机mma和tig']
TOKYOJING	['tokyo金南俊']
Jasmine	['jasmine', 'jasmine英文名', 'jasmine flower', 'jasmina', 'jasmine怎么读', 'jasmine什么意思中文', 'jasmine和张艺兴', 'jasmine英文名禁忌', 'jasmine即刻电音', 'jasmin香水']
MARTINI	['martini', 'martina', 'martin luther king', 'martine', 'martin什么意思中文', 'martini酒', 'martin吉他', 'martins', 'martin freeman', 'martin酒']
InterContinental	['intercontinental', 'intercontinental洲际酒店', 'intercontinental上海', 'intercontinental hotel上海', 'intercontinental怎么读', 'intercontinental长沙', 'intercontinental广州', 'intercontinental成都', 'intercontinental翻译']
INSTYLE-2	['instyle造型', 'instyle造型价目表', 'instyle中文是什么意思', 'instyle是什么牌子', 'instyle创始人', 'instyle造型官网', 'instyle优家画报', 'instyle美发创始人', 'instyle理发店', 'instyle造型创始人']
张妈妈	['张嫣', '张妈妈特色川味馆', '张茂才', '张妈,把这个房间的所有衣服', '张婉儿', '张娜', '张娜拉', '张娜娜', '张妈妈私房菜 杨迪说的']
LLJ	['llm', '伦理', 'lpl', '伦理剧', 'otto 璐璐', 'lloyd', 'llc', '萝莉', '李连杰']
INShairsalon2	['inshairsalon楚皓']
云川台球三里屯店	['云川台球三里屯店电话']
walahuoguo	['蛙辣火锅', '蛙辣火锅图片']
1001night	['1001nights', '1001nights天野喜孝', '1001night']
CHAO	['查快递', 'chanel', '长安十二时辰', 'change', '长安', '查快递单号', 'charge', '长城', 'chair', 'chase']
HomeInns	['homeinn什么意思']
BRACKET	['bracket', 'bracken', 'bracket是什么意思中文翻译', 'bracket什么意思', 'tracker', 'bracket coffee', 'bracket怎么读', 'bracken fern', 'bracket英语什么意思', 'bracket 翻译']
Moonshine	['moonshine', 'moonshine是什么意思', 'moonshine and valentine', 'moonshine conjecture', 'moonshine valley', 'moonshine and molly', 'moonshine是什么牌子', 'moonshine 18k金款', 'moonshine酒吧', 'moonshine图标包']
sanfulong	['三福龙景 福清', '三福龙景最新房价', '三福龙廷多少一平方', '三福龙景龙廷二手房', '三福龙景 总经理', '三福龙景龙廷房价', '三福龙景龙廷户型图', '三福龙景初中划片', '三福龙景沙县小吃', '三辅龙拳之十步拳']
小七君私房菜	['小七君私房菜', '小七君私房菜怎么样', '小七君私房菜(金台路店)', '小七君私房菜(工体店)怎么样', '小七君私房菜(工体店)', '小七君私房菜(金台路店)怎么样', '小七君私房菜 大众点评']
caixin	['菜系', '菜心', '财新网', '彩霞', '采撷', '菜心的做法', '蔡幸娟', '蔡秀军', '蔡小心', '财新周刊']
mizuki	['mizuki 瑞葵结婚了吗', 'mizuki 瑞葵真实姓名', '米族空气净化器', 'mizuka', 'mizuki微导管', '专业主妇 mizuk', '米祖克拉米提']
YJXCGY	['杨记兴臭鳜鱼的位置', '永吉县车管所新址', '杨记兴臭鳜鱼清真吗', '延津县城关初级中学', '眼睛下长个小肉疙瘩', '杨记兴臭鳜鱼团结湖店', '月经血从宫颈口流出来', '杨记兴臭鳜鱼加盟费', '孕检血常规血小板偏低', '杨记兴臭鳜鱼']
HaiDiLaoHuoGuo	['海底捞火锅底料哪个好吃', '海底捞火锅怎么吃', '海底捞火锅底料', '海底捞火锅加盟', '海底捞火锅加盟费吗', '海底捞火锅加盟费多少', '海底捞火锅底料怎么调', '海底捞火锅价格表', '海底捞火锅成立于哪一年', '海底捞火锅']
Toybox	['toybox', 'toyboy是什么牌子的', 'toyboy包包正品多少钱', 'toyboat', 'toyboy是什么意思啊', 'toyboy的包会不会丢人', 'toyboat怎么读', 'toyboy什么档次', 'toybox是什么意思', 'toyboys吧']
NiaoTun	['鸟图', '尿毒症', '鸟图片大全大图鸟名称', '尿突然是红褐色的是什么问题', '尿突然变少是什么原因', '鸟腿断了自己能恢复吗', '鸟图片简笔画彩色', '鸟兔死走狗烹', '鸟图腾', '鸟图片卡通']
shijiajingpin	['世家精品酒店怎么样', '世家精品酒店', '世嘉景品质量如何', '世嘉景品 fate rider', '世家精品酒店(垦利店)怎么样', '世家精品酒店电话', '世家精品酒店团结湖', '实家精品超市怎么样', '世嘉景品fgo阿福', '世嘉景品手办怎么样怎么样']
CINKERCINEMAS	['cinkercinemas三克影院怎么样', 'cinkercinemas(三里屯店)怎么样', 'cinkercinemas(三里屯店) 概况', 'cinkercinemas(三里屯店) 评论']
西部马华	['西部马华拉面加盟', '西部马华是清真餐厅吗', '西部马华食府', '西部马华火锅', '西部马术竞技钢琴曲', '西部马华北京有多少店', '西部马术', '西部马华拉面创始人', '西部马华创始人马华', '西部马华简介']
super8	['superm', 'supervision', 'superior', 'superme什么意思', 'superman', 'supermarket', 'super junior', 'super junior m', 'superhero', 'superb']
yanweidie	['燕尾蝶', '燕尾定理', '燕尾钉', '燕尾蝶歌词', '燕尾蝶图片', '燕尾钉规格尺寸', '燕尾蝶的寓意', '燕尾定理等五大模型', '燕尾定理证明', '燕尾钉图片']
中国联通-D-one	['中国联通董事长是谁', '中国联通东方财富', '中国联通董事长级别', '中国联通东小口营业厅', '中国联通东莞分公司', '中国联通冬奥会广告词', '中国联通董事会成员', '中国联通东塘自营厅', '中国联通东四营业厅', '中国联通东光营业厅']
xiaohongpaoS	['小红袍', '小红袍火锅', '小红袍龙虾馆', '小红袍茶叶', '小红袍花椒', '小红袍豫剧', '小红袍花椒介绍', '小红袍龙虾', '小红袍茶叶多少钱一斤', '小红袍和大红袍的区别']
WEST	['west', 'western', 'westin', 'wesg', 'western blot', 'westwood', 'wes认证', 'westray', 'wesley', 'westpac']
hooters1	['hooters餐厅', 'hooters猫头鹰餐厅', 'hooters是什么意思', 'hooters北京停业', 'hooters陆家嘴', 'hooters餐厅北京', 'hooters餐厅可以摸吗', 'hooters餐厅 成都', 'hooters餐厅营业状况', 'hooters为何关门']
麻辣男女	['麻辣男女火锅加盟', '麻辣男人 迪克牛仔', '麻辣男人', '麻辣男女', '麻辣男人歌词']
shuilintianyue	['水临天玥', '水临天玥歺牌价格', '水临天玥商户概况', '水林天月酒吧 东大桥']
SIR.TEEN	['sirteen酒吧', 'sir.teen', 'sirteen散客门票', 'sirteen翻译中文', 'sirteen酒吧门票', 'sirteen酒单', 'sirteen是是什么意思', 'sirteen散台低消', 'sirteen散台多少钱', 'sirteen酒吧消费']
BakerandSpice	['bakerandspice 黑麦面包100%', 'bakerandspice 北京']
MCD-ChinaNet	['mcd-chinanet']
D-one	['d-one', "don't", 'donkey', 'donate', 'done什么意思中文翻译', "don't break my heart", 'donkey of guizhou', 'donut', 'donation', 'donkey是什么中文意思']
lantern	['lantern读音', 'lantern festival']
zhaolonghotel	['zhaolonghotelbeijing.cn']
MUSE	['牧神记', 'museum', 'must', 'music', 'muse', 'muscle', 'mushroom', 'musician', 'musical', 'mustang']
LOFT	['lofter', 'loft', 'loft公寓', 'lof基金', 'loft什么意思', 'lofty', 'lofter官网', 'lofi', 'lofter网页版', 'lofree']
xiaogechuanchuan	['小哥串串香(三里屯店)怎么样', '小哥串串香(银河SOHO店)怎么样', '小哥串串香(回龙观店)怎么样', '小哥串串香(金源店)怎么样', '小哥串串香(银河SOHO店)']
carmen	['carmel', 'carmex', 'carmen的意思', 'carmera', 'carmela', 'carmer', 'carmen英文名', 'carmex唇膏', 'carme d']
有家生煎	['有家生煎', '有家生鲜', '有家生鲜超市怎么样', '有家生煎可以加盟吗']
dk1308	['dk1306发动机正时图', 'dk1308', 'dk1308音乐美食城', 'dk1306发动机正时', 'dk1308西餐厅', '贷款130万25年怎么', '贷款130万', '贷款13000利息多少', '贷款130万每月还多少', '贷款130万利息是多少']
dipingxian	['地平线', '地平线4', '地平线摩托车', '地平线3', '地平线零之曙光', '地平线机器人', '地平线武器箱', '地平线公司', '地平线4手机版下载', '地平线游戏下载']
拿铁酒吧1	['拿铁酒吧老板背景', '拿铁酒吧义乌', '拿铁酒吧舞曲', '工体cl拿铁酒吧', '三里屯拿铁酒吧', '齐齐哈尔拿铁酒吧', '北京工体拿铁酒吧', '广安拿铁酒吧', '太和拿铁酒吧', '高密拿铁酒吧']
Ginger	['ginger', 'gingerbread', 'ginger ale', 'gingerly', 'ginger怎么读音', 'ginger什么意思', 'gingerbread man', 'ginger tea', 'gingersnap', 'ginger可数吗']
elephant	['elephant', 'elephant 怎么读', 'elephant什么意思思', 'elephant是什么意思中文', 'elephant儿歌', 'elephant是什么意思', 'elephant bird', 'elephant man', 'elephant in the room', 'elephant音标']
niaotun	['鸟图', '尿毒症', '鸟图片大全大图鸟名称', '尿突然是红褐色的是什么问题', '尿突然变少是什么原因', '鸟腿断了自己能恢复吗', '鸟图片简笔画彩色', '鸟兔死走狗烹', '鸟图腾', '鸟图片卡通']
rijin	['日记', '日记格式', '日进斗金', '日久生情', '日记200', '日记100字大全', '日积月累', '日经指数', '日记英文', '日久见人心']
小小美甲	['小小美发师', '小小美人鱼', '小小美猴王', '小小美人鱼歌曲', '小小美可以做什么', '小小美钰', '小小美食家手抄报', '小小美猴王动画片全集', '小小美发师3', '小小美人鱼舞蹈']
didiao	['低调组合', '低调看', '低调看直播', '低调图片', '地点', '低调组合承认是情侣', '地垫', '低调高手', '地点副词', '低调奢华']
LaoTie	['老铁', '老田', '烙铁', '烙铁头', '老铁是什么意思', '老天爷', 'laoting', '老铁山', '老铁视频下载', 'lotion']
shangbangdaisi	['上邦戴斯精品酒店', '上邦戴斯酒店网评', '上邦戴斯', '上邦戴斯酒店', '上邦戴斯酒店集团', '上邦戴斯酒店管理集团怎么样', '上邦戴斯酒店招聘', '上邦戴斯温泉酒店', '上邦戴斯酒店北京', '上邦戴斯酒店管理有限公司']
Playhouse	['playhouse', 'playhouse酒吧', 'playhouse什么意思', 'playhouse成都', 'playhouse长沙', 'playhouse重庆', 'playhouse酒吧创始人', 'playhouse怎么读', 'playhouse成都价格']
拿铁酒吧	['拿铁酒吧老板背景', '拿铁酒吧义乌', '拿铁酒吧舞曲']
世家精品酒店	['世家精品酒店', '世家精品酒店怎么样', '世家精品酒店(垦利店)怎么样', '世家精品酒店从团结湖哪个出口出', '世家精品酒店到清华附中', '世家精品酒店朝阳区农', '世家精品酒店到中国农大东校区', '世家精品酒店团结湖电话']
QMEX	['qme5y', 'qmega', '青霉素', 'qmex', '青梅竹马', 'omega是什么牌子的手表', 'qmenu', '去马尔代夫旅游要多少钱', 'q萌头像', 'qmele']
xiaochunrihe	['小春日和', '小春日和露丝猫', '小春日和 露娜猫微盘', '小春日和露丝猫百度云', '小春日和 (h)露娜猫', '小春日和 露娜猫txt', '小春日和露丝猫书包', '小春日和txt.百度云', '小春日和是什么意思']
晟永兴2	['晟永兴烤鸭店', '晟永兴烤鸭店三里屯', '晟永兴二里庄餐厅', '晟永兴烤鸭', '晟永兴烤鸭二里庄电话', '晟永兴烤鸭店怎么样', '晟永兴烤鸭店创始人', '晟永兴烤鸭店价格表', '晟永兴烤鸭店的老板', '晟永兴烤鸭店太阳宫店']
haidilaoPOS	['海底捞破100亿', '海底捞破100亿发红包', '海底捞破100亿微信']
velvet	['velvet', 'velvety', 'velveteen', 'velvet意思', 'red velvet', 'velvet是什么牌子口红', 'velvety怎么读', 'velver', 'velvet underground', 'velvet怎么读音']
Knight魔术酒吧	['knight魔术酒吧', 'knight魔术酒吧附近停车场', 'knight魔术酒吧消费']
republic	['republic', 'republic of korea', 'republic什么意思', 'republic of china什么意思', 'republic of game', 'republic怎么读', 'republication', 'republic of singapore', 'republic是哪个国家', 'republic mexican银币']
huangmen	['黄玫瑰', '黄焖鸡', '黄梅戏', '黄梦莹', '黄梅', '黄焖鸡米饭', '黄焖鸡做法', '黄美英', '黄梅县', '黄美珍']
Scandal	['scandalous', 'scandal and liber', 'sandal', 'scada系统', 'scandalize', 'scandal什么意思啊', 'scandalous香水', 'scandal香水什么牌子', 'scandal什么意思口语', 'scandal游戏']
XLKHG	['小龙坎火锅', '小龙坎火锅菜单价目表', '星礼卡和星享卡的区别', '心率快会引起什么症状', '小龙坎火锅怎么样', '谢利可汗', '星灵口号', '雪里看花', '心律快好还是漫好', '选理科还是文科好']
BOTTEGA	['bottega是什么牌子', 'bottega官网', 'bottega veneta', 'bottega手提包', 'bottega鞋', 'bottega香槟', 'bottega钥匙扣', 'bottega是什么牌子酒,多少钱啊', 'bottega酒', 'bottega是什么牌子酒']
爸爸烤肉	['爸爸烤肉', '爸爸烤的苹果派', '爸爸烤肉林更新', '爸爸烤肉是谁开的', '爸爸烤肉林更新开哪里', '爸爸烤肉店', '爸爸烤肉店地址上海', '爸爸烤肉店人均多少', '爸爸烤肉多少钱', '爸爸烤肉加盟官网']
DK1308	['dk1306发动机正时图', 'dk1308', 'dk1308音乐美食城', 'dk1306发动机正时', 'dk1308西餐厅', '贷款130万25年怎么', '贷款130万', '贷款13000利息多少', '贷款130万每月还多少', '贷款130万利息是多少']
jinguixiaoshancheng	['金簋小山城', '金簋小山城牛蛙', '金簋小山城 春秀路', '金簋小山城分店电话', '金簋小山城(亚运村店)怎么样', '金簋小山城(南湖东路店)怎么样', '金簋小山城(簋街一店)怎么样', '金簋小山城(秦皇大街店)怎么样', '金簋小山城(簋街总店)怎么样', '金簋小山城(总店)商户概况']
zhanhouse	['战吼萨', '战吼萨卡组最新2019', '战厚顺', '战吼萨狂野', '战吼萨卡组', '战后世界三大经济支柱', '战吼是什么意思', '战吼随从加2费', '战吼萨代码', '战吼萨百分百回收']
cows	['cowboy', 'coward', 'cow是什么意思', 'cow怎么读音', 'cowardly', 'cowgirl', 'cower', 'cowl', 'crow']
bodhi	['bodhi', 'bodhisattva', '博士', 'bodies', 'bodhi是什么意思', 'bodhidharma', 'bodhran', '波士顿大学', '波士顿', 'bodhi jones']
3AM-B1	['3am背景墙', '3am北京三里屯']
Cargo	['cargill', 'cargo什么意思中文', 'charge', 'carina', 'cargo pants', 'vcard', 'carbon', 'cargo tracking', 'cargo receipt']
同心阁	['同心难改', '同心兄弟', '同心县', '同心结', '同心同德', '同心协力', '同心圆', '同心锁', '同心云', '同心度']
R-kiss	['orkis', 'sarkis', 'markis', 'serkis', '色珂serkis']
ONETHIRD	['one third酒吧']
njdpd	['南京大排档在哪', '南京大牌档必点菜推荐', '南京大排档', '南京大排档必点的菜', '年纪的拼音', '宁静的拼音', '南京大牌档', '疟疾的拼音', '南京大排档深圳店地址', '脑筋的拼音']
LetsBURGERplus	['letsburgerplus 菜单', 'letsburgerplus 蓝港', 'letsburgerplus怎么读', 'letsburgerplus是加盟店吗', 'letsburgerplus网红', 'letsburgerplus价格', 'letsburgerplus天津', 'letsburgerplus 上海']
IBIZA-B3	['ibiza百度百科', 'ibiza比赛视频', 'ibiza百科', 'ibiza蹦迪', 'ibiza比赛第一视角']
为美好相聚沸腾	['为美好相聚沸腾']
bajianchuan	['拔尖创新人才', '拔尖创新人才培养模式', '巴尖串串加盟', '巴尖串串的鲍鱼是啥', '拔尖创新人才实验班', '巴建川', '八件传说中的厨具']
tongxinge	['童星', '同性恋', '通信工程', '同性', '同型半胱氨酸高是怎么回事', '同型半胱氨酸', '同性恋是心理疾病还是生理疾病', '同行半路', '通行证']
laotao	['老太太', '老态龙钟', '老唐', '老饕', '老坛酸菜', '老太太garanny', '老太婆', '老台门', '老坛酸菜牛肉面', '老汤']
yuebeixiaocheng	['粤北小城', '粤北小城法人', '粤北小城金地中心店', '粤北小城关门了', '粤北小城(三里屯世茂店)怎么样', '粤北小城世贸百货店怎么样', '粤北小城(世贸百货店)', '粤北小城·潮汕砂锅粥怎么样']
Berko-1	['berkore是什么牌子', 'berko蛋糕店']
XDHDSJ	['写大海的诗', '写大海的诗句有哪些', '写东海的诗词', '现代化的四合院效果图', '写大海的诗歌小学生', '现代化电视墙背景', '性淡化的世界txt下载', '喜鼎海胆水饺老板是谁', '新都恒大三河场', '想大喊的说说']
三公潮汕牛肉火锅1	['三公潮汕牛肉火锅三里屯店', '三公潮汕牛肉火锅三里屯']
神坛小馆	['神坛小说排行榜']
GoodBait	['good拜英语怎么写', 'good百度翻译', 'good拜的歌曲', 'goodbai读音', 'good白啥意思是什么', 'good拜拜英文翻译']
大龙燚火锅	['大龙燚', '大龙燿怎么读', '大龙燚火锅', '大龙燿火锅推荐']
ZWYN	['钟无艳', '只为遇见你', '赠我予白', '植物园', '植物医生', '猪瘟疫情最新消息', '正午阳光', 'zwyn', '赵惟依', '赠我予白百度云']
ANCHOR-0	['anchor是什么意思中文', 'anchorage', 'anchor奶粉怎么样', 'anchorage是哪个城市', 'anchor是什么品牌啊', 'anchor主持人', 'anchor怎么读音', 'anchor是什么奶粉', 'anchor自行车']
串鸟屋	['串鸟是什么意思', '树串鸟', '柳串鸟', '沈阳镁都串鸟']
桥底串吧	['桥底串吧', '桥底串吧的老板是谁', '桥底串吧创始人', '桥底串吧怎么样', '桥底串吧老板王帅', '桥底串吧 韩士博']
ROOF	['root', 'roof', 'room', 'rooster', 'rookie', 'roots', 'root大师', 'rook', 'root什么意思', 'root权限']
蒙之宝	['蒙之痴痴 抱布贸丝', '蒙自源', '蒙迪欧', '遽怎么读', '蒙之旅旅行社', '蒙之情旅行社', '蒙之羊', '蒙语', '蘧怎么读', '蒙之旅']
RestaurantY	['restaurant怎么读', 'restaurant怎么读英语', 'restaurant 是什么意思', 'restaurant是什么意思中文', 'restaurant是什么意思中文翻译', 'restaurant怎么记', 'restaurant音标', 'restaurant的中文', 'restaurant游戏', 'restaurant.crew.crew翻译']
Shuilintianyue	['水临天玥', '水临天玥歺牌价格', '水临天玥商户概况', '水林天月酒吧 东大桥']
SWING58	['swing5300充电器']
PacificCoffee	['pacificcoffee奥园店', 'pacificcoffee月饼', 'pacificcoffee(大悦城店)怎么样', 'pacificcoffee怎么读', 'pacificcoffee深圳', 'pacificcoffee大悦城-活力体验馆怎么样', 'pacificcoffee官网', 'pacificcoffee价格']
Amo	['amd', 'amg', 'among', '阿玛尼', 'amazon', 'amy', 'amazing', 'amount', '阿莫西林', 'nami']
Vplus	['vplus', 'volume', 'vplus酒吧', 'vplus会员 什么意思', 'vplus眼镜', 'vp路由器n']
instyle	['instyle', 'instyle造型', 'instyle中文是什么意思', 'instyle造型价目表', 'instyle是什么牌子', 'instyle是什么意思', 'instyle创始人', 'instyle造型官网', 'instyle优家画报', 'instyle美发创始人']
hongyitang_n2	['弘医堂倪金霞出诊表单']
Buerjiuguan	['不二酒馆怎么样', '不二酒馆斯斯与帆']
REDREAM	['redream', 'redream模拟器安卓版', 'redream模拟器', 'redream安卓', 'redream官网']
YingLanQuanXi	['樱兰全息养生馆正规吗', '樱兰全息养生馆怎么样', '樱蘭全息养生馆怎么样', '樱蘭全息养生馆 评论', '樱兰全息养生馆 东直门外大街']
INSTYLE1	['instyle造型', 'instyle造型价目表', 'instyle中文是什么意思', 'instyle是什么牌子', 'instyle创始人', 'instyle造型官网', 'instyle优家画报', 'instyle杂志', 'instyle美发创始人', 'instyle是什么意思']
COSTA2	['costa咖啡', 'costa mesa', 'costa咖啡中文叫什么', 'costar', 'costal', 'costco', 'cos太乙真人', 'costa菜单', 'costarica是哪个国家', 'costa邮轮']
Anchor	['anchorage', 'anchor是什么意思中文', 'anchovy', 'anchor奶粉怎么样', 'anchor point', 'anchoret', 'anchor free', '安重根', 'anchor是什么意思中文翻译', 'anchor音乐']
马路牙子地桌烤肉	['马路牙子地桌烤肉(工体店) 概况', '马路牙子地桌烤肉密码', '马路牙子地桌烤肉望京店', '马路牙子地桌烤肉(工体店)怎么样', '马路牙子地桌烤肉(工体店)商户概况', '马路牙子地桌烤肉加盟', '马路牙子地桌烤肉(工体店)用户评论']
pintec	['pinterest', 'pintec', '品特轩55677 高手之家', 'printer', 'www.pinterest.com', 'pintech', 'pintek', 'pinter软件', 'pinter是什么意思']
mubei	['墓碑', '木北造型', '母贝', '木北', 'mubea', '木本植物', '墓碑图片', 'mulberry', '母本差', '墓碑线']
北京长虹医院	['北京长虹医院', '北京长虹医院怎么样', '北京长虹医院是正规医院吗', '北京长虹医疗美容医院怎么样', '北京长虹医院整容好吗', '北京长虹医院是私立的还是国家的', '北京长虹医疗美容医院', '北京长虹医院可靠吗', '北京长虹医院地址', '北京长虹医院电话']
李嘉嘉	['李嘉欣', '李嘉格', '李嘉铭', '李嘉琪', '李嘉诚控制的香港媒体', '李嘉慧', '李嘉雯', '李嘉迎', '李佳琦']
OneThird	['one third酒吧']
bianyifang	['便宜坊', '便宜坊烤鸭', '便宜坊怎么读', '便宜反义词', '便宜坊烤鸭多少钱一只', '便宜坊烤鸭和全聚德烤鸭的区别', '便宜坊烤鸭店', '便宜坊烤鸭店总店地址', '便宜坊烤鸭价目表', '便宜坊总店']
CJIA	['c级', '超级人生', 'c级车', '长江', '超级大乐透', 'c级锁芯', '超级女婿', '吃鸡', '超级仙学院', 'c级奔驰']
xiaozhang	['肖战敷眼膜现身', '肖战', '肖战图片', '肖战微博', '小丈夫', '嚣张', '肖战综艺', '肖战 顾医生', '肖战签名']
HUAXING	['花心', '华信', '华欣', '画心', '花芯', '华新水泥', '华信航空', '华歆', '华星光电', '画心师']
rongshangzaoxing	['融尚造型', '融尚造型(工体北路一店)怎么样', '融尚造型(工体北路一店)', '融尚造型(工体北路一店) 评论', '融尚造型(工体北路二店)怎么样']
dongfangliang	['东方脸', '东方联盟', '东方联盟郭盛华', '东方亮彩精密技术有限公司', '东方联盟官方网站', '东方亮彩', '东方联盟创始人郭盛华', '东方恋觉想', '东方恋莲录']
Wolfgang1	['wolfgang puck', 'wolfgang牛排', 'wolfgang什么意思', 'wolfgang是谁', 'wolfgang puck米其林', 'wolfgang puck是谁', 'wolfgang see', 'wolfgang相机包里的布', 'wolfgang超感', 'wolfgang牛排上海地址']
艺薯家	['艺薯家', '艺薯家土豆焗饭大师']
TheRug	['therubz', 'therug王府中环店', 'therug', 'therumi灰姑娘面膜', 'the如何发音', 'the如何使用', 'the弱读发音', 'the如何读']
dazhangfu	['大丈夫', '大账房', '大丈夫日记', '大丈夫电视剧全集48', '大丈夫小媳妇', '大丈夫2', '大丈夫日语', '大丈夫能屈能伸', '大丈夫生于天地间 岂能久居人下', '大丈夫何患无妻']
shaoxiashi	['烧虾师总部在哪里', '烧虾什么时候 放盐', '烧下是什么原因', '烧虾师', '烧虾师傅多少钱一个月', '少侠是什么意思', '烧下水道用什么', '烧下是什么病', '烧霞是什么意思', '少侠是男的还是女的']
ifensi	['ifensi', 'ifensi电视盒子密码', 'ifensi机顶盒装软件', 'ifensi 盒子 app']
Caixin	['菜系', '菜心', '财新网', '彩霞', '采撷', '菜心的做法', '蔡幸娟', '蔡秀军', '蔡小心', '财新周刊']
ShiTangZui	['食堂最好的大学', '食堂租赁合同范本', '食堂最多的大学', '食堂最好吃的大学', '食堂做饭的人怎么称呼', '食堂做饭招聘', '食堂做饭工最新招聘', '食堂做账', '食堂最好的专科', '食堂最新菜品图片']
Hacker-Pschorr	['hackerpschorr渔人码头乐队', 'hackerpschorr咖啡']
东方饺子王	['东方 饺子王电话号码']
aojiameishuguanjiudian	['奥加美术馆酒店电话', '奥加美术馆酒店-地面停车场怎么样', '奥加美术馆酒店为何小姐多', '奥加美术馆酒店地铁能到吗', '奥佳美术馆酒店怎么座地铁', '奥加美术馆酒店夜总会电话', '澳加美术馆酒店底下KTV叫什么', '奥加美术馆酒店(东直门外大街26号)', '奥加美术馆酒店附近地铁站']
sushitong	['宿世通', '苏轼同榜进士名单', '苏事通', '苏轼同时代诗人有哪些', '苏试同名的三苏是', 'sushi桐', '苏轼同科进士有哪些', '速食桶饭如何使用', '速食通餐饮管理系统', '苏世同']
hooters2	['hooters餐厅', 'hooters猫头鹰餐厅', 'hooters是什么意思', 'hooters北京停业', 'hooters陆家嘴', 'hooters餐厅北京', 'hooters餐厅可以摸吗', 'hooters餐厅 成都', 'hooters餐厅营业状况', 'hooters为何关门']
rampage	['rampage', 'rampage是什么意思', 'rampage电影', 'rampage是什么牌子', 'rampageous', 'rampage exile', 'rampage v extreme', 'rampage from exile', 'rampage iii gene', 'rampage牌子衣服价格']
Velvet	['velvet', 'velvety', 'velveteen', 'velvet意思', 'red velvet', 'velvet是什么牌子口红', 'velvety怎么读', 'velver', 'velvet underground', 'velvet怎么读音']
bookworm	['bookworm', 'bookworm是什么意思啊', 'bookworm怎么读', 'bookworm beijing', 'bookworm官网', 'bookworm oxford', 'bookworm是个贬义词吗', 'bookworm书虫系列']
instyle2	['instyle造型', 'instyle造型价目表', 'instyle中文是什么意思', 'instyle是什么牌子', 'instyle创始人', 'instyle造型官网', 'instyle优家画报', 'instyle杂志', 'instyle美发创始人', 'instyle是什么意思']
HUAZHU_Hanting	['华住汉庭的密码是什么', '华住汉庭', '华住汉庭宁波', '华住汉庭酒店wifi密码', '华住汉庭索菲亚', '华住汉庭酒店数据泄漏', '华住汉庭电话是多少', '华住汉庭wifi密码认证', '华住汉庭酒店', '华住汉庭官网']
HaiDiLaoDianCai	['海底捞点餐技巧', '海底捞点菜都是ipad', '海底捞点餐', '海底捞点菜系统', '海底捞点餐攻略', '海底捞点菜的平板咋用', '海底捞点菜', '海底捞点菜攻略', '海底捞点菜攻略2人', '海底捞点餐系统']
请晋山西餐社	['请晋山西餐社乔家大院', '请晋山西餐社怎么样', '请晋山西餐社(好运街店)怎么样', '请晋山西餐社(三里屯时光列车)怎么样', '请晋山西餐社(好运街店)', '请晋山西餐社(好运街店)商户概况', '请晋山西餐社(三里屯时光列车店)商户概况', '请晋山西餐社老板是谁']
Algorithm	['algorithm', 'algorithmic', 'algorithm是什么意思', 'algorithm函数', 'algorithm翻译', 'algorithm头文件', 'algorithm negotiation fail', 'algorithmic trading', 'algorithm怎么读', 'algorithm engineer']
haolinju	['好邻居超市加盟费', '好邻居超市', '好邻居电影讲述的什么', '郝琳杰', '好邻居的说说', '好邻居房产联盟 登陆', '好邻居房产', '好邻居便利店', '浩林集团', '好邻居']
F-SPACE	['佛山平安车险服务热线', '佛山平安车险', '佛山平安车险营业厅', '发烧泡艾草', '佛山品爱橱柜', '发烧泡艾草浴有效果吗', '肤色偏暗穿粉色合适吗']
buerjiuguan2	['不二酒馆怎么样', '不二酒馆斯斯与帆']
wangjingxiaoyao	['望京小腰加盟多少钱', '望京小腰图片', '望京小腰是什么腰子', '望京小腰做法', '望京小腰总店在哪', '望京小腰', '望京小腰怎么样', '望京小腰哪家是真的', '望京小腰总店', '望京小腰加盟']
WALA1	['瓦剌', '瓦拉内', '蛙来哒', '瓦莱乔', '瓦莱罗', '瓦蓝', '瓦拉克', '瓦莱塔', 'walan', '瓦拉纳西']
zhaolong-hotel	['zhaolonghotelbeijing.cn']
yinyuetai.com	['yinyuetai.com Yinyuetai', 'yinyuetai.com 音悦tai', 'yinyuetai.com Face中文字幕认人版--音悦Tai_222', 'yinyuetai.com/video/3298430']
thebell	['thebell是什么意思', 'thebell', 'thebell中文翻译']
Revolution	['revolution', 'revolutionary', 'revolution吉他网易云', 'revolution吉他音频', 'revolution one', 'revolution指弹mp3', 'revolution法国品牌', 'revolution指弹教学', 'revolution桃花妆教程', 'revolution吉他谱']
黑泷太郎	['黑泷太郎', '黑泷太郎加盟费多少', '黑泷太郎官网', '黑泷太郎品牌介绍', '黑泷太郎奶茶店怎么样', '黑泷太郎好喝吗', '黑泷太郎配方', '黑泷太郎图片', '黑泷太郎装修风格', '黑泷太郎 上海']
珍滋味港式粥火锅	['珍滋味港式粥火锅菜单', '珍滋味港式粥火锅(工体店)', '珍滋味港式粥火锅加盟', '珍滋味港式粥火锅(新源西里店)怎么样', '珍滋味港式粥火锅官网', '珍滋味港式粥火锅怎么样', '珍滋味港式粥火锅(工体店)商户概况', '珍滋味港式粥火锅价格', '珍滋味港式粥火锅(工体店)网友评论', '珍滋味港式粥火锅(新源西里店)']
WeWork	['wework', 'wework上海', 'wework北京', 'wework官网', 'wework是什么公司', 'wework深圳', 'rework', 'wework融资亿', 'wework股权', 'wework杭州']
THERUG	['therubz', 'therug王府中环店', 'therug', 'therumi灰姑娘面膜', 'the如何发音', 'the如何使用', 'the弱读发音', 'the如何读']
WALA2	['瓦剌', '瓦拉内', '蛙来哒', '瓦莱乔', '瓦莱罗', '瓦蓝', '瓦拉克', '瓦莱塔', 'walan', '瓦拉纳西']
STAFOOD	['stafood', 'stafood面馆无双官网', 'stafood面馆无双怎么样', 'stafood面馆无双菜单']
ONSTAR	['onstage', 'onstar', 'onstage的意思', 'onstar系统', 'onstart', 'onstar怎么读', 'onstar是干嘛的', 'onstar热点', '怪物monsta', 'sonsta']
IBIZA	['ibiza', 'ibiza绝地求生', 'ibiza耳机', 'ibiza微博', 'ibiza直播', 'ibiza虎牙', 'ibiza鼠标', 'ibiza灵敏度', 'ibiza设置', 'ibiza虎牙直播']
rich-healthcare	['rich-healthcarecm', "rich-healthcarecom~911100560120一395E'"]
didiao2	['低调', '低调组合', '低调看直播', '低调高手', '低调图片', '低调组合承认是情侣', '低调奢华', '低调术士', '低调英文', '低调看球']
蟹老宋	['蟹老板', '蟹老弟', '蟹老宋', '蟹老板图片', '蟹老板的女儿', '蟹老板简笔画', '蟹老弟app', '蟹老板头像', '蟹老板图片 简笔画', '蟹老弟上征信吗']
Jindingxuan	['金鼎轩', '金鼎轩二公子大凡', '金鼎轩菜单', '金鼎轩二公子', '金鼎轩地坛店', '金鼎轩菜单及价格', '金鼎轩雍和宫店地址', '金鼎轩24小时营业', '金鼎轩团结湖店', '金鼎轩方庄店电话']
BUU	['bug', '不良人', 'burberry', 'buff', 'busy', 'ebuy', 'burn', 'bun', 'but', 'bus']
jindingxuan	['金鼎轩雍和宫店地址', '金鼎轩二公子', '金鼎轩菜单', '金鼎轩地坛店', '金鼎轩', '金鼎轩24小时营业', '金鼎轩方庄店电话', '金鼎轩菜单及价格', '金鼎轩团结湖店', '金鼎轩二公子大凡']
xiaotudou...	['小土豆怎么做好吃', '小土豆的做法', '小土豆', '小土豆咸菜的做法', '小土豆奶瓶怎么样', '小土豆扣奥尼尔视频', '小土豆怎么去皮', '小土豆隔扣奥尼尔视频', '小土豆奶瓶', '小土豆的做法大全家常']
qiaowaipo	['乔外婆麻辣香锅铁营桥', '乔外婆麻辣香锅', '乔外婆', '桥外婆麻辣香锅', '乔外婆麻辣香锅方庄', '乔外婆六里桥店关了', '乔外婆麻辣香锅加盟', '乔外婆东铁营店', '乔外婆 六里桥', '巧外婆私房菜']
东方名剪	['东方名都', '东方名城', '东方名剪', '东方明珠', '东方名苑', '东方名狮', '东方名府', '东方名殿', '东方名郡', '东方名园']
Honda	['honda', 'honey', 'honda摩托车', 'honduras', 'honda是什么牌子', '红豆', 'honest', 'good', 'honda civic', 'honda汽车']
巅峰造型	['巅峰造极是什么意思', '登峰造极境', '巅峰造句', '巅峰造极致', '巅峰造极境的意思', '巅峰造诣的科学家2', '巅峰造就虚伪的拥护者', '巅峰造型 方庄电话', '巅峰造假粉']
zhengyuanyuan	['郑远元', '郑媛媛', '郑远元专业修脚房', '郑远元专业修脚房加盟', '郑远元治灰指甲真实吗', '郑远元专业修脚房附近', '郑远元专业修脚房怎么样', '郑远元修脚房价格表图', '郑远元专业修脚店', '郑媛元']
@百万庄园方庄店	['百万庄园方庄店', '百万庄园方庄地址']
娄三少	['娄山关', '娄三娄四人物形象', '娄三关的讲解', '娄三少', '娄三公子', '娄山关在哪里', '娄三少春饼', '娄三娄四', '娄三观的诗词', '娄三公子 娄四公子']
xiaotudou..	['小土豆怎么做好吃', '小土豆的做法', '小土豆', '小土豆咸菜的做法', '小土豆奶瓶怎么样', '小土豆扣奥尼尔视频', '小土豆怎么去皮', '小土豆隔扣奥尼尔视频', '小土豆奶瓶', '小土豆的做法大全家常']
小龙坎老火锅	['小龙坎老火锅', '小龙坎老火锅使用老油', '小龙坎老火锅用老油', '小龙坎老火锅回收油', '小龙坎老火锅事件', '小龙坎老火锅加盟费', '小龙坎老火锅怎么样', '小龙坎老火锅地址', '小龙坎老火锅官网', '小龙坎老火锅电话']
味多美刘家窑地铁店	['味多美刘家窑地铁店']
LAOBAOSAN	['老爆三', '老爆三的做法', '老爆三是什么', '老爆三饭店所有地址', '老爆三是回民菜吗', '老爆三的正宗做法图片', '劳保三证一标是什么', '老爆三样', '老爆三欢乐谷店电话', '老爆三样的回民做法']
99inn	['99inn无线网登录', '99inn.cc']
鸿运天外天	['鸿运天外天烤鸭店', '鸿运天外天烤鸭店丰台', '鸿运天外天万丰路店', '鸿运天外天烤鸭店(万丰路店)怎么样', '鸿运天外天烤鸭店(刘家窑店)怎么样', '鸿运天外天烤鸭店(会城门店)怎么样', '鸿运天外天烤鸭店(新街口店)怎么样', '鸿运天外天烤鸭店(西三旗店)怎么样', '鸿运天外天烤鸭店(虎坊路店)怎么样', '鸿运天外天烤鸭店(海淀南路店)怎么样']
dawanju	['大玩家', '大碗居', '大玩家斗地主', '打完九价疫苗注意事项', '大碗井', '大玩家超乐场', '大玩家 福建少儿', '大腕经典台词', '大玩家电影']
YLKYD	['伊朗扣押英国油轮', '饮料可以带上飞机吗', '饮料可以托运吗', '原来可以等到你', '宜良烤鸭哪家最好吃', '易来客运', '鱼鳞可以吃吗', '药流可以在家自己流吗', '玉林烤鸭店', '宜良烤鸭']
5i5j	['5i5j', '5i5j官网', '5i5i', '5i5car', '5i5j官网南京', '5i5j杭州官网', '5i5j苏州', '光影精灵5i5', '暗夜精灵5i5', '2cd3t25i5']
RYB	['ryan', '日元', 'ryona', '荣耀', '日元汇率', 'rye', '日元对人民币汇率', '荣耀9x pro', '荣耀9x', '荣耀v20']
ChunBingKaoYaDian	['春饼烤鸭店顺三条', '春饼烤鸭店(刘家窑顺三条店)怎么样', '春饼烤鸭店(刘家窑顺三条店)', '春饼烤鸭店推荐顺四条', '春饼烤鸭店的电话号码?', '春饼烤鸭店(方庄店)怎么样']
Laochengyiguo	['老城一锅', '老城一锅羊蝎子', '老城一锅羊蝎子加盟', '老城一锅羊蝎子火锅加盟费多少', '老诚一锅羊蝎子', '老城一锅羊蝎子做法', '老诚一锅和老城一锅', '老诚一锅羊蝎子加盟费多少', '老诚一锅羊蝎子火锅加盟', '老城一锅电话']
ZGGJWJY	['中国歌剧舞剧院张珊珊', '中国歌剧舞剧院李大威', '中国歌剧舞剧院李玉刚', '中国古建屋脊的装饰', '中国歌剧舞剧院 余瑜', '中国国际文具博览会', '中国歌剧舞剧院培训', '中国歌剧舞剧古筝考级', '志高挂机外机不启动', '中国国际文交所怎么玩']
一麻一辣	['一麻一辣', '一麻一辣星缘餐饮', '一麻一麦', '一麻一辣麻辣香锅地址', '一麻一辣麻辣香锅', '一麻一辣麻辣香锅总部', '一麻一辣总部', '一麻一辣香锅', '一麻一辣麻辣烫', '一麻一麻袋什么意思']
HaiYinHaiJi	['海银海记', '海银海记潮汕火锅', '海银海记潮汕牛肉火锅', '海银海记菜单', '海银海记电话', '海银海记牛肉', '海银海记上市了吗', '海银海记保山', '海银海记 美股', '海银海记深圳旗舰店']
诚记鲜牛肉火锅	['诚记鲜牛肉火锅']
Sinopec	['sinopec', 'sinopec是什么意思', 'sinopecsales.co m', 'sinopec全称', 'sinoped', 'sinopec怎么读', 'sinopec是什么公司', 'sinopec全称怎么读', 'sinopec机油怎么样']
北京何所有酒店	['北京何所有酒店电话', '北京何所有酒店刘家窑', '北京何所有酒店怎么样', '北京何所有酒店地址', '北京何所有酒店 几星', '北京何所有酒店招聘', '北京何所有酒店到北京南站打车', '北京何所有酒店图片', '北京何所有酒店 南站', '北京何所有酒店到北京天坛医院新圵的路线']
dinghaishenzhen	['定海神针', '定海神针清屏专用超长', '定海神针刷屏', '定海神针是成语吗', '定海神针比喻什么意思', '定海神珍', '定海神针图片', '定海神针软件', '定海神针是什么意思', '定海神针是哪个龙王的']
木屋烧烤	['木屋烧烤加盟', '木屋烧烤', '木屋烧烤创始人美国', '木屋烧烤官网', '木屋烧烤生蚝几点半价', '木屋烧烤半价时间', '木屋烧烤加盟费多少', '木屋烧烤创始人马克', '木屋烧烤海鲜5折时间', '木屋烧烤创始人']
洞庭鱼香	['洞庭鱼尾', '洞庭鱼米乡', '洞庭鱼米乡歌曲原唱', '洞庭鱼米乡简谱', '洞庭鱼头王', '洞庭鱼米乡何纪光', '洞庭鱼米乡歌词', '洞庭鱼香', '洞庭鱼排', '洞庭鱼香科创三街电话']
julongwatankaoyangtui1	['聚龙娃炭烤羊腿(平谷店)(平谷店)怎么样', '聚龙娃炭烤羊腿(临江店)怎么样', '聚龙娃炭烤羊腿(京东旗舰店)怎么样', '聚龙娃碳烤羊腿(刘家窑店)商户概况', '聚龙娃炭烤羊腿京东旗舰店怎么样', '聚龙娃碳烤羊腿(机场店)怎么样', '聚龙娃炭烤羊腿(郑州总店)怎么样', '聚龙娃炭烤羊腿(刘家窑店)怎么样']
fengmaokaochuan-2	['丰茂烤串', '丰茂烤串加盟', '丰茂烤串官网', '丰茂烤串加盟费多少钱', '丰茂烤串总店', '丰茂烤串全国分店地址', '丰茂烤串加盟官网', '丰茂烤串电话', '丰茂烤串冬天店内经营视频', '丰茂烤串加盟费多少']
丰茂烤串5	['丰茂烤串官网', '丰茂烤串加盟', '丰茂烤串总店', '丰茂烤串加盟费多少钱', '丰茂烤串全国分店地址', '长春丰茂烤串', '丰茂烤串菜单', '北京丰茂烤串', '延吉丰茂烤串', '丰茂烤串加盟官网']
丰茂烤串6	['丰茂烤串官网', '丰茂烤串加盟', '丰茂烤串总店', '丰茂烤串加盟费多少钱', '丰茂烤串全国分店地址', '长春丰茂烤串', '丰茂烤串菜单', '北京丰茂烤串', '延吉丰茂烤串', '丰茂烤串加盟官网']
涩谷造型	['涩谷造型']
ZGTLGJ	['中国铁路股票', '中国铁路干线分布图', '中国铁路官网', '中国铁路工程集团有限公司', '中国铁路广州局待遇', '中国铁路工人', '中国土猎狗', '中国铁路归谁管', '主观体力感觉等级表', '中国铁路轨道尺寸']
非凡活力	['非凡活力健身荣丰2008', '非凡活手机', '非凡活手机什么意思', '非凡活力 游泳价格']
不是烧烤	['不是烧烤', '不是烧烤总店', '不是烧烤马连道店电话', '37度是不是烧']
柏翠酒窖	['柏翠酒庄', '柏翠酒窖', '柏翠酒店', '柏翠酒庄的酒', '柏翠酒价格', '柏翠酒行怎么加盟']
味道工坊	['味道工厂', '味道工作人员', '味道工坊淘宝买不到了']
hanlinkaorou	['韩林烤肉', '翰林烤肉']
高兴一锅	['高兴夫', '高兴一锅汕头牛肉火锅加盟', '高兴英语', '高兴地什么', '高兴一锅', '高兴地', '高兴一快乐的词语', '高兴一天是一天的成语', '高兴一锅潮汕火锅地址', '高兴一点的图片大全']
丰茂烤串2	['丰茂烤串官网', '丰茂烤串加盟', '丰茂烤串总店', '丰茂烤串加盟费多少钱', '丰茂烤串全国分店地址', '长春丰茂烤串', '丰茂烤串菜单', '北京丰茂烤串', '延吉丰茂烤串', '丰茂烤串加盟官网']
国投商务酒店	['国投商务酒店无线网密码']
tangquanliangzi	['汤泉良子', '汤泉良子价目表', '汤泉良子怎么样', '汤泉良子加盟', '汤泉良子需要带泳衣吗', '汤泉良子亦庄店', '汤泉良子山水文园团购', '汤泉良子丽都店团购', '汤泉良子通州店价格表', '汤泉良子足道']
不老溪老菜馆1	['不老溪老菜馆(荣丰店)怎么样', '不老溪老菜馆怎么样']
骏怡连锁酒店	['骏怡连锁酒店价格', '骏怡连锁酒店', '骏怡连锁酒店简介', '骏怡连锁酒店电话', '骏怡连锁酒店投诉电话多少', '骏怡连锁酒店app下载', '骏怡连锁酒店丰禾路', '骏怡连锁酒店官网app', '骏怡连锁酒店总部地址', '骏怡连锁酒店台州店']
zhangqiuhaitai	['章丘海泰食府菜单价格', '章丘海泰', '章丘海泰集团张建军', '章丘海棠小筑', '章丘海泰集团福利待遇', '章丘海泰饭店(西站店)', '章丘海泰新材料怎么样', 'zhangqiuhaitaidajiudian', '章丘海泰饭店-火车票飞机票代售点怎么样', '章丘海泰食府怎么样']
yunhuisuo	['云会所', '云辉塑料制品有限公司']
BIDR	['鼻窦炎', 'bid是一天几次', 'bid是什么意思啊', '壁咚', 'bidet', '彼得兔', 'bide', '彼得潘', 'bids', '鼻窦']
CMEC	['cmec', 'came', 'cmef', 'come', 'cmf', 'cmea', 'cmeo', 'cmel', 'cmes']
fengmaokaochuan	['丰茂烤串', '丰茂烤串加盟', '丰茂烤串官网', '丰茂烤串加盟费多少钱', '丰茂烤串总店', '丰茂烤串全国分店地址', '丰茂烤串加盟官网', '丰茂烤串电话', '丰茂烤串冬天店内经营视频', '丰茂烤串加盟费多少']
bulaoxilaocaiguan	['不老溪老菜馆(荣丰店)怎么样']
spzp	['水瓶座', '生僻字', '水瓶座今日运势', '视频在线', '水瓶座女生', '水瓶座男生', '水瓶座和什么星座最配', '水瓶座明星', '尚品宅配', '水瓶座男生性格']
京味斋	['京味斋', '京味烤鸭', '京味楼', '京味高干文', '京味电视剧', '京味儿', '京味张', '京味轩', '京味歌曲', '京味小说']
podinns	['podinns是什么意思']
匆匆那年	['匆匆那年', '匆匆那年电视剧', '匆匆那些年', '匆匆那年歌词', '匆匆那年小说', '匆匆那年结局', '匆匆那年歌曲', '匆匆那年好久不见', '匆匆那年泰剧', '匆匆那年简谱']
CHAOZHOUHUI	['潮州壶', '潮州话', '潮州话在线发音', '潮州话翻译', '潮州话骂人经典的100句', '潮州火车站在哪里', '潮州火车站', '潮州华侨中学', '潮州汇侨大酒店', '潮州胡荣泉']
NOVOTEL	['novotel', 'novotel酒店几星', 'novotel是什么意思', 'novotel酒店', 'novotel酒店 上海', 'novotek', 'novotel新加坡', 'novotel上海atlantis', 'novotel首尔', 'novotel怎么读']
siyeniula	['四爷牛拉是清真的吗', '四爷牛拉创始人', '四爷牛拉总店在哪', '四爷牛拉创始人吴熙花', '四爷牛拉面门店', '四爷牛拉']
hehuatai	['荷花塘', '荷花塘图片', '荷花塘儿歌', '荷花塘图片简笔画', '荷花唐诗', '荷花塘荷花香鱼儿欢跳捉迷藏', '荷花桃花梅花菊花按顺序排列一下', '荷花泰菜餐厅', '荷花谈到人生的说说', '荷花塘里荷花飘']
jiangtaiwuer	['将太无二北京店', '将太无二菜单价目表', '将太无二什么档次', '将太无二', '将太无二什么意思', '将太无二加盟费', '将太无二是自助吗', '将太无二人均', '将太无二菜单', '将太无二储值卡']
Joyinn	['joying', 'joying什么意思', 'joyins', 'jo英文名', 'joyin什么意思', 'jo英文怎么读', 'jo音标', 'jo英文名适合女生吗', 'jo音标怎么读', 'jo英文名是什么意思']
-华纺酒店-	['北京正义路华纺酒店']
戈拿旺巴西烤肉	['戈拿旺巴西烤肉自助餐', '戈拿旺巴西烤肉菜市口店', '戈拿旺巴西烤肉价钱', '戈拿旺巴西烤肉团购', '戈拿旺巴西烤肉表演', '戈拿旺巴西烤肉亚运村', '戈拿旺巴西烤肉(亚运村直营店)怎么样', '戈拿旺巴西烤肉(崇文门店)', '戈拿旺巴西烤肉(亚运村直营店)', '戈拿旺巴西烤肉(菜市口店)商户概况']
Guangming-Daily	['光明代理商', '光明代理', '光明代理电话是多少', '光明带来什么好处', '光明代理能赚到钱吗', '光明代理怎么销售', '光明代理布的结构', '光明代理打赏是什么', '光明带来希望作文']
hankoujietou	['汉口街头', '汉口街头 太阳宫', '汉口街头 国瑞城店', '汉口街头 餐馆']
DingJunHui	['丁俊晖', '丁俊晖最新比赛消息', '丁俊晖2019最新比赛', '丁俊晖比赛', '丁俊晖撕广告', '丁俊晖世界排名', '丁俊晖2019最新排名', '丁俊晖排名世界第几名']
tiancifuyuan1	['天赐福缘', '天赐福院四合院酒店', '天赐福缘是什么意思', '天赐福院酒店怎么样', '天赐福缘美容美生店', '天赐福元通宝背面是什么样子的', '天赐福缘是什么生肖', '天赐福缘通宝有多少种看一看图案', '天赐福缘吉庆有余']
Super8	['super junior', 'superior', 'supermarket', 'superm', 'superb', 'superman', 'super junior m', 'superme什么意思', 'supervision', 'superhero']
mingshiguang	['茗视光', '茗视光眼科医院', '铭仕管业', '名士官网', '茗视光眼科医院好不好', '名仕观邸', '名实关系', '茗视光眼科医院地址', '茗视光眼科医院电话', '铭仕管业质量如何']
yunhaiyao	['云海肴特色菜必点菜', '云海肴汽锅鸡', '云海谣', '云海肴', '云海肴官网', '云海肴北京有多少家店', '云海肴创始人', '云海肴云南菜', '云海肴菜单', '云海肴加盟']
huachengshishang	['华程时尚酒店', '华诚食尚酒店地址', '花城时尚酒店', '华程时尚酒店的地图', '华程时尚宾馆怎么样', '花城时尚酒店怎么样', '华城食尚酒店怎么样', '华程时尚酒店(北京崇文门地铁站店)怎么样', '华诚时尚自助火锅城怎么样', '花城时尚酒店晚上几点关门']
99inn.cc	['99inn.cc']
rongchengguli	['荣成鼓浪屿洗浴搬那里', '蓉城故里', '蓉城故里酒楼崇文门', '荣成鼓浪屿', '荣成古老村庄', '荣成鼓浪屿洗浴中心', '蓉城故里酒楼怎么样', '荣成顾玲珑', '荣成鼓浪屿洗浴套四']
便宜坊哈德门店	['便宜坊哈德门店', '便宜坊哈德门店电话', '便宜坊哈德门怎么样', '便宜坊哈德门店地铁', '便宜坊哈德门地址', '便宜坊哈德门店团购', '便宜坊哈德门烤鸭店怎么样', '便宜坊哈德门店特色菜', '便宜坊哈德门店需要排队不', '便宜坊哈德门店地址']
DBS	['东北大学', 'dbm', 'db11', 'dbc', 'dbp', '豆瓣', '帝霸', 'dba', 'dbs', 'dbq']
BlueNote	['blue note 北京']
wendingfu	['稳定反义词', '温鼎府', '稳定发展', '稳定房地产市场调控', '问鼎峰哥版博听网', '问鼎方博2', '稳定负债比例计算公式', '稳定风险评估方案', '稳定肥大细胞 药物', '稳定封冻期']
fenglianbinguan	['烽联宾馆']
HuoLuHuo	['火炉火加盟费', '火炉火自助多少钱', '火炉火菜单', '火鹿灬念什么', '火炉火', '火炉火自助是随便点吗', '活芦荟可以直接涂脸吗', '火炉火南瓜粥的做法', '火炉火自助', '火炉火烤肉']
99inn.cn	['99inn.cc']
BYBO	['巴音布鲁克', '薄一波', 'bybus', '半月板', '不孕不育', 'bybike', 'baby', 'byblock', 'bybe', 'by2']
tiancifuyuan3	['天赐福缘', '天赐福院四合院酒店', '天赐福缘是什么意思', '天赐福院酒店怎么样', '天赐福缘美容美生店', '天赐福元通宝背面是什么样子的', '天赐福缘是什么生肖', '天赐福缘通宝有多少种看一看图案', '天赐福缘吉庆有余']
ciming	['慈铭体检', '慈铭', '慈铭体检中心', '慈铭体检电话', '慈铭体检官网', '慈铭体检怎么样', '刺明', '慈铭体检报告', '慈铭体检时间', '慈铭体检中心电话']
思妍丽	['思妍丽', '思妍丽美容院', '思妍的名字是什么意思', '思妍丽官网', '思妍金巢安功效与主治', '思妍乳乐通的功效', '思妍金巢安', '思妍丽健身', '思妍丽加盟费', '思妍丽产品加盟']
tangchaoktv	['糖潮ktv', '唐朝ktv', '糖潮ktv价格', '糖潮ktv团购', '唐朝ktv中关村店', '糖潮ktv中关村店', '糖潮ktv价格是多少']
岩之畔	['岩之呼吸', '岩之魂', '岩之柱', '岩之律者', '岩之氧', '岩之有礼', '严稚棱', '岩之畔', '岩之巨人', '岩之有礼肉桂价格']
zizhuyezonghui2	['紫竹夜总会是干嘛的', '紫竹夜总会洗脸', '紫竹夜总会消费水平', '紫竹夜总会北京几环路', '紫竹夜总会经理电话']
徽风阁	['徽风皖韵', '徽风皖韵什么意思', '徽风阁', '徽风色影', '徽风皖韵三日游', '徽风古韵舞蹈视频', '徽风蜀韵', '徽风蜀韵私房菜电话', '徽风皖韵酒h9报价']
YMSQ	['疫苗事件', '颜美食', '亚马逊', '沂蒙山', '野蛮师姐', '云梦四时歌', '一亩三分地', '云蒙山', '玉门市', '亚麻色']
zizhuyezonghui8	['紫竹夜总会是干嘛的', '紫竹夜总会洗脸', '紫竹夜总会消费水平', '紫竹夜总会北京几环路', '紫竹夜总会经理电话']
北京市党派团体办公楼	['北京市党派团体办公楼', '北京市党派团体办公楼服务管理中心']
MeiNianDaJianKang	['美年大健康体检可信吗', '美年大健康官网', '美年大健康', '美年大健康体检中心报告查询app', '美年大健康招聘', '美年大健康体检中心', '美年大健康体检中心官网查看报告', '美年大健康体检中心电话', '美年大健康体检中心怎么样', '美年大健康股票']
juelvbang	['倔驴帮']
lashangyin	['辣上瘾', '辣尚瘾烤鱼', '辣上瘾代理', '辣尚瘾麻辣香锅加盟费多少', '辣上瘾小吃', '辣上瘾加盟', '拉伤应该热敷还是冷敷', '拉伤英文怎么说', '辣尚瘾官方网站', '辣尚瘾总公司在哪里']
五台云	['五台山', '五台山在哪里', '五台山天气预报', '五台山天气', '五台县', '五台山门票', '五台山图片', '云台山', '五台山在哪个省', '五台山旅游']
acfic	['acfun', 'acfic', 'acfine', 'acfive是什么意思中文', 'acfive在车上什么意思']
川成元	['川成语', '川成商住楼', '川成元', '四川外国语大学成都学院', '川成语接龙', '四川成都大学', '川成元 麻辣香锅', '川成医药', '川成先生,你会变成那种人类吗', '川成语有哪些']
川渝小馆	['川渝小面', '川渝小厨', '川渝小吃类似混沌', '川渝小吃,类似馄饨,皮薄而润滑', '川渝小吃加盟', '川渝小镇', '川渝小厨 榆林', '川渝小面做法', '川渝小哥微博', '川渝小厨怎么样']
nongtangli	['弄堂里', '农汤老店', '弄堂里餐厅', '浓汤老豆腐', '浓汤拉面', '浓汤凉面条的做法', '浓汤螺丝怎么做', '浓汤拉菲黄鱼的做法', '浓汤栗子娃娃菜', '弄汤里 海鲜']
CECEP	['测测', '测测星座', 'cecelia', '测测你的古代身份', '侧侧轻寒', '侧侧轻寒的小说', 'cece包', 'cereal', '测测你的军人潜质', '贝贝']
Tai_Shu_Xi	['太熟悉家常菜', '太熟悉你的关怀 分不开', '太熟悉了肿么破', '太熟悉你的关怀', '太叔喜欢宁舒吗', '太熟悉家常菜惠新店', '太叔姓', '太熟悉你的关怀什么歌', '太熟悉了肿么破完整版']
yunledi	['云乐迪私影汇', '云乐迪私影汇枫蓝国际', '云乐迪电影吧', '云乐迪私影汇多少钱', '孕了低吃黄体酮软胶囊', '云乐迪私影汇有监控吗', '晕了肚脐难受怎么回事', '云乐迪私人影院', '芸乐多']
shuimumicheng	['水木迷城密室逃脱攻略', '水木迷城密室逃脱怎么样', '水木迷城密室逃脱(中关村旗舰店)怎么样', '水木迷城密室逃脱(四季青店)怎么样', '水木迷城狼人杀桌游VR游戏馆怎么样', '水木迷城真人密室逃脱怎么样', '水木迷城密室逃脱(明光桥店)怎么样', '水木迷城密室逃脱(大悦城南店)怎么样', '水木迷城密室逃脱答案']
Sizzler	['sizzler', 'sizzler餐厅', 'sizzler什么意思啊', 'sizzle是什么意思啊', 'sizzler是什么菜', 'sizzle it your way', 'sizzler food', 'sizzler时时乐西餐厅', 'sizzler餐厅收费标准', 'sizzler餐厅是自助吗']
水木迷城2	['水木迷城密室逃脱攻略', '水木迷城密室逃脱怎么样', '水木迷城密室逃脱(中关村旗舰店)怎么样', '水木迷城密室逃脱(四季青店)怎么样', '水木迷城狼人杀桌游VR游戏馆怎么样', '水木迷城真人密室逃脱怎么样', '水木迷城密室逃脱(明光桥店)怎么样', '水木迷城密室逃脱(大悦城南店)怎么样', '水木迷城密室逃脱答案']
xizhimenbinguan	['西直门宾馆', '西直门宾馆电话', '西直门宾馆不对外营业', '西直门宾馆地址', '西直门宾馆预定', '西直门宾馆套间价格', '西直门宾馆官方网站', '西直门宾馆附近地铁站', '西直门宾馆 游泳', '西直门宾馆多少钱']
ROUCHUANWANGZONGDIAN	['肉串汪总店怎么样']
tangchaoKTV	['糖潮ktv', '唐朝ktv', '糖潮ktv价格', '糖潮ktv团购', '唐朝ktv中关村店', '糖潮ktv中关村店', '糖潮ktv价格是多少']
BJSFRBG	['宝鸡书法任步武', '北京市丰瑞宾馆']
汤城小厨	['汤城小厨', '汤城小厨菜单及价格表', '汤城小厨官网', '汤城小厨菜单', '汤城小厨东方新天地店', '汤城小厨金源店', '汤城小厨招聘信息', '汤城小厨银泰中心店', '汤城小厨是哪里菜', '汤城小厨什么菜好吃']
tpyzq	['太平洋战争', '天篷妖尊', '太平洋证券股票', '头皮痒怎么办', '天蓬妖尊免费全文阅读', '太平洋证券', '太平洋中间是什么脑筋急转弯', '头皮溢脂性皮炎', '田拼音怎么写']
gymboree	['gymboree']
bianjinggongheguo	['边境共和国 大众点评', '边境共和国(荟聚购物中心)', '边境共和国(美罗城店)怎么样', '边境共和国天津大悦城']
HuXiaoShanZhuang~1F	['呼啸山庄1992', '呼啸山庄1998', '呼啸山庄1992版百度云', '呼啸山庄1992演员表', '呼啸山庄1939在线观看', '呼啸山庄1992免费观看', '呼啸山庄1998剧照', '呼啸山庄1992豆瓣', '呼啸山庄1939 下载', '呼啸山庄1998版百度云']
BNU	['bnp', 'bnd-al10', 'bboy', '百年灵', 'bnu', 'bni', 'bnb', 'bnd-al00', 'bot', 'box']
tingyun	['听雨', '庭院', '停运', '庭院设计', '听雨的诗句', '庭院深深', '停运高铁', '庭院深深深几许', '停运列车', '听雨楼']
CUPONE	['coupon是什么意思中文翻译', 'coupon rate', 'coupon的意思', 'coupon 翻译', 'coupons怎么读音发音', 'coupon怎么读音', 'cupone', '醋泼尼龙松副作用', 'coupon的汉语意思', 'cupon是什么意思']
yuxueyuan	['育学园', '育学园app下载', '育学园会员值得吗', '育学园诊所', '育学园电话', '语学院', '育学园的东西正品吗', '予学原文及译文', '育学园怎么删除多添加的宝宝', '玉雪缘面膜多少钱一盒']
CCB	['cctv5', 'cctv', 'cctv1', 'cc直播', 'cctv13', 'cctv6', 'cctv7', 'cctv5节目', 'cctv4', 'ccb']
huashangjiudian	['华商酒店', '华商酒店管理有限公司', '华商酒店 三元桥', '华商酒店(厦门湾店)怎么样', '华商酒店-中餐厅怎么样', '华商酒店(淦河大道)怎么样', '华商酒店-KTV怎么样', '华商酒店行李架弄坏了', '华商酒店到郑州东站多少钱']
眉州小吃	['眉州小吃是哪里的特色', '眉州小吃 鸡丝凉面', '眉州小吃会员怎么办', '眉州小吃菜单图及价格', '眉州小吃招聘信息', '眉州小吃加盟费多少', '眉州小吃菜单', '眉州小吃关店', '眉州小吃早餐菜单', '眉州小吃']
CUPONE-2	['cupone什么意思']
beifangyouyicun	['北方又一村电话', '北方又一村营业时间', '北方又一村商户概况', '北方又一村法人是谁', '北方又一村在线菜单']
suzumei	['suzume翻译', 'suzumei北京', 'suzume 什么品种']
@张亮麻辣烫	['张亮麻辣烫', '张亮麻辣烫是谁开的', '张亮麻辣烫加盟费用', '张亮麻辣烫加盟', '张亮麻辣烫加盟费用需要多少钱', '张亮麻辣烫创始人和杨国福', '张亮麻辣烫老板叫什么', '张亮麻辣烫官网', '张亮麻辣烫和杨国福哪个好吃', '张亮麻辣烫多少钱一斤']
CUPONE-1	['cupone什么意思']
dizhibinguan	['地质宾馆', '地质宾馆餐厅']
helijia-bj	['河狸家北京总部电话', '河狸家百度百科', '合力夹抱叉车图片', '河狸家不为男士服务吗']
小筑酒店2	['广州樱花小筑酒店', '土华樱花小筑酒店', '厦门唐乐小筑酒店', '云间小筑酒店', '梅州圣山小筑酒店', '江津惜梦小筑酒店', '杭州西湖燕隅小筑酒店', '成都巧思小筑酒店', '重庆云间小筑酒店', '福州恩泽小筑酒店']
黎明园宾馆	['黎明园宾馆']
wanglibank	['王黎扮演者']
迪亚天天	['迪亚天天', '迪亚天天营业时间', '迪亚天天超市', '迪亚天天加盟要求', '迪亚天天官网', '迪亚天天加盟', '迪亚天天会员卡', '迪亚天天加盟费', '迪亚天天超市最新促销']
meishenxuqing	['美神煦氰医疗美容', '美神煦氰', '美神煦氰美啦门诊', '美神煦氰整形', '美神煦氰美啦门诊地址', '美神煦氰美啦门诊骗', '美神煦氰生物胶粘合', '美神煦氰結婚了嗎', '美神煦氰双眼皮价格']
nadu	['纳达尔', '纳豆', 'nadh', 'nadph', 'nada', '那达慕', 'nadim', 'nader', '纳豆的功效', '南澳岛']
Ibis	['ibiza', 'ibis', 'ibil', 'ibiza绝地求生', 'ibid', 'ibiza耳机', 'ibike', 'ibiden', 'ibiza设置', 'ibiza微博']
xibeihanzi	['西北汉子', '西北汉子的性格特点', '西北汉子餐厅', '西北汉子子歌曲', '西北汉子喝西夏广告', '西北汉族基因', '西北汉子是西安吗', '西北汉子喝西夏', '西北汉子电话京旺电话', '西北汉子郑一楠']
helijia	['鹤立鸡群', '河狸家', '鹤立鸡群的意思', '和离记', '鹤立鸡群的近义词', '河狸家官网', '河立鸡群图是什么时候的', '鹤立鸡群是什么生肖', '河狸家客服', '赫里将军']
huajiayiyuan	['花家怡园四合院', '花家怡园四季青店', '花家怡园', '花家怡园金融街店', '花家怡园融科店', '花家怡园菜单', '花家怡园清华西路店', '花家怡园圆明园店', '花家怡园惠新店', '花家怡园东直门店']
Bluche	['blucher', 'bluchat注册不了', 'bluch中文是什么意思', 'bluchin', 'bluch是什么意思', 'bluchat怎么注册', 'blu车牌白色', 'blu车牌', 'blu车牌什么意思']
ccb	['cctv5', 'cctv', 'cctv1', 'cc直播', 'cctv13', 'cctv6', 'cctv7', 'cctv5节目', 'cctv4', 'ccb']
Homeinns	['homeinn什么意思']
wennuandelvtu	['温暖的旅途作文六百字', '温暖的旅途800字作文', '温暖的旅途写作思路', '温暖的旅途图片唯美', '温暖的旅途700字作文', '温暖的旅途作文500字', '温暖的旅途作文开头', '温暖的旅途900字', '温暖的旅途500字', '温暖的旅途作文400字']
lanhuhui	['澜湖会', '蓝湖汇vip公馆', '烂乎乎的食物有什么', '蓝壶花类', '蓝湖汇vip公馆2019', '蓝糊糊是什么动画片', '蓝狐狐狸', '蓝乎乎红图图唧唧啾啾', '蓝呼呼', '蓝湖汇vip公馆 张帆']
wanglaoliu	['王老六', '王老六铁锅炖鱼', '王老六说唱歌词', '王老六的说唱bgm', '王老六大街上手搂嫩模', '王老六怎么不更新了', '王老六铁锅炖鱼创始人', '王老六说唱民以食为天', '王老六计算器说唱视频']
shikongtang	['时空探长', '时空堂董事长戴孔堂', '时空探员天赋', '时空探案录 新笔趣阁', '时空探险', '时空堂 戴孔堂 手机', '时空坍缩什么意思']
salahuaer	['撒拉花儿西域美食', '撒拉花儿', '撒拉花儿是什么意思', '撒拉花儿太阳宫电话', '萨拉花儿太阳宫', '撒拉花儿亚运村店电话']
beiwaiqingshao	['北外青少', '北外青少英语', '北外青少英语校区', '北外青少英语校区电话', '北外青少校区', '北外青少英语app安卓', '北外青少官网', '北外青少英语培训中心怎么样', '北外青少英语官网平台', '北外青少英语费用']
RBT	['日本', '日本漫画', 'rbc', '日本少女漫画', '日本电影院', '日币汇率', '日本动漫', '人保电话']
muwushaokao	['木屋烧烤', '木屋烧烤店', '木屋烧烤几点海鲜半价', '木屋烧烤官网', '木屋烧烤菜单', '木屋烧烤营业时间', '木屋烧烤老板', '木屋烧烤加盟费多少', '木屋烧烤创始人']
4008190099	['4008190099']
menggongfang	['梦工坊', '梦工坊咖啡吧', '梦工坊影城', '梦工坊app', '梦工坊咖啡', '梦工坊青年', '梦工坊技术', '梦工坊影城蔡塘', '梦工坊咖啡吧地址', '梦工坊影城在厦门哪里']
saboten	['saboteur', 'saboten', 'saboteur桌游规则', '萨博特种汽车有限公司', 'saboteur 游戏', 'saboten是什么意思', '萨伯特螺杆泵厂家', '萨伯特陶瓷是品牌吗', '萨博特地砖', '萨柏特地砖怎么样']
CFLD	['超凡黎明', 'cf零', 'cf乱世', 'cfld', 'cf论坛', 'cf轮回', 'cf灵狐者', 'cf雷霆套装', 'cf雷霆', 'cf雷神']
qiaobamei	['乔巴萌图', '俏巴妹串串', '俏巴妹烤鱼团购', '俏巴妹烤鱼平乐园店', '乔巴萌图高清大图', '乔巴没带帽子图片', '乔巴美甲', '乔巴没有帽子图片']
@机场巴士	['机场巴士时刻表', '机场巴士', '机场巴士怎么买票', '机场巴士1号线', '机场巴士2号线', '机场巴士浙江音乐学院线时间表', '机场巴士怎么乘坐', '机场巴士330时刻表', '机场巴士昌平线时刻表', '机场巴士多少钱']
奥莲特	['奥莲娜提利尔', '奥莲娜', '奥莲娜·雷德温', '奥莲姬', '奥莲娜结局', '奥莲娜提利尔扮演者']
shenmimei	['神秘玫瑰奥修课程', '神秘魅少不好惹免费', '神秘美人鱼', '神秘萌宝:总裁爹地翻身战', '神秘玫瑰', '神秘玫瑰培训课', '神秘美人鱼电影免费版', '神秘美容院漫画全集在线观看', '神秘梦魇小说', '神秘美医疗美容']
城市之光6	['城市之光东望', '城市之光楼盘', '城市之光电影', '城市之光卓别林', '心理罪之城市之光', '万科城市之光', '城市之光豆瓣', '城市之光结局', '城市之光香烟价格', '城市之光香烟']
chanzuimao	['馋嘴猫', '馋嘴猫加盟', '馋嘴麻辣烫', '馋嘴麻辣烫加盟费', '馋嘴猫零食加盟', '馋嘴猫图片', '馋嘴猫串吧', '馋嘴猫串串香', '馋嘴猫加盟,总部在哪里', '馋嘴猫烤肉拌饭']
HOSA	['host', 'hospital', 'hostile', 'hostess', 'hospitality', 'hosts', 'hostage', 'hospice', 'hospital怎么读', 'hose是什么意思中文']
lanzhoulamian	['兰州拉面', '兰州拉面的做法', '兰州拉面是哪个民族', '兰州拉面汤料配方单', '兰州拉面图片', '兰州拉面排行榜', '兰州拉面为什么不让喝酒', '兰州拉面热量', '兰州拉面的面怎么和面', '兰州拉面是哪里人开的']
yuzhiguang	['预制管', '预制管桩', '预制管桩验收规范标准', '预制管桩施工控制要点', '预制管桩价格', '预制管桩施工方案', '玉之光', '预制管桩接桩', '玉之光整形美容', '于指关节会痛怎回事']
wangsteak	['往steam平台发游戏']
城市之光	['城市之光', '城市之窗', '城市之星', '城市之间', '城市之家', '城市之音', '城市之心', '城市之光东望', '城市之声', '城市之星物流单号查询']
xespy	['学而思培优', '学而思培优和学而思的区别', '小儿双扑伪麻', '学而思拼团', '学而思培优上班时间', '学而思培训班加盟连锁', '小儿速朴康的功效', '学而思培优西安总部', '学而思培优老师工资', '学而思培优请假退费吗']
nanmensijishuanrou	['南门四季涮肉', '南门四季涮肉亚运村店', '南门四季涮肉左家庄店', '南门四季涮肉怎么样', '南门四季涮肉(芍药居北里店)怎么样', '南门四季涮肉(五棵松店)怎么样', '南门四季涮肉五棵松店', '南门四季涮肉(亚运村店)商户概况', '南门四季涮肉(立水桥店)', '南门四季涮肉(芍药居北里店)']
五指生	['五指毛桃', '五指山', '五指毛桃的功效与作用', '五指视频', '五指姑娘', '五指操作', '五指毛桃煲汤配什么', '五指岩', '五指峰', '五指石']
chuanshifengge	['川式风格装修效果图', '川式风格农村自建房', '传世风格是什么意思']
HUAZHU-Hanting.	['华住汉庭酒店wifi密码', '华住汉庭', '华住汉庭酒店', '华住汉庭官网', '华住汉庭宁波', '华住汉庭酒店数据泄漏', '华住汉庭积分多久到账', '华住汉庭优惠券', '华住汉庭索菲亚', '华住汉庭电话是多少']
小南国	['小南瓜的做法', '小南瓜', '小南国', '小南瓜怎么做好吃', '小南风', '小南代号', '小南海', '小南被按在地上叫', '小南的戒指带哪跟手指', '小南瓜的功效与作用']
hongxizu	['鸿喜族', '鸿喜族养生会馆', '红喜字图片', '虹吸作用', '鸿喜族养生会馆泡妹子', '虹吸作用原理', '红喜字', '洪溪镇', '红系增生明显活跃是什么意思', '鸿喜中餐']
大亨小厨	['大亨小传', '大亨小传电影', '大亨小馆', '大亨小传 汪苖', '大亨小厨', '大亨小说明王心', '大亨小传小说', '大亨小专', '大亨小传汪梵mobi', '大亨小厨电话']
tuojiangxiaozhen	['沱江小镇', '沱江小镇对外经贸大学', '沱江小镇餐饮管理有限公司', '沱江小镇(安贞店)商户概况']
动感易带网吧	['动感易带网吧怎么样']
sinopec	['sinopec', 'sinopec是什么意思', 'sinopecsales.co m', 'sinopec全称', 'sinoped', 'sinopec怎么读', 'sinopec是什么公司', 'sinopec全称怎么读', 'sinopec机油怎么样']
伊藤洋华堂亚运村店	['伊藤洋华堂亚运村店', '伊藤洋华堂亚运村营业时间', '伊藤洋华堂亚运村店退换货', '伊藤洋华堂亚运村点1楼新开化妆品什么牌子', '伊藤洋华堂亚运村店电话']
Yitel	['伊藤润二', '伊藤博文', '伊藤', '异特龙', '伊藤诚', '一人之下', '伊藤洋华堂', '伊藤园', '伊藤健太郎']
Atour	['吖头', 'atoi', 'around', 'atour 酒店', 'atour什么意思', 'atout', 'touch', '阿童木', '阿托品', 'arouse']
CKI	['ck回应林允解约', 'ck官网', 'ck手表', 'ckd', 'ck香水', '查快递', '查快递单号', 'cl', '小ck']
城市之光3	['城市之光东望', '城市之光楼盘', '城市之光电影', '城市之光卓别林', '心理罪之城市之光', '万科城市之光', '城市之光豆瓣', '城市之光结局', '城市之光香烟价格', '城市之光香烟']
bengeshousi	['本格寿司', '本格寿司 北京', '本格寿司 杭州']
bibichi	['比比成语', '必必成语', '比比虫怕啥东西', '吡吡虫啉能杀那些害虫', '弊弊绰绰什么意思', '哔哔车是什么', '比比车公司怎么样', '毕毕成语', '比比虫是什么样的', '比比成语有哪些']
@茶花妹子过桥米线	['茶花妹子过桥米线', '茶花妹子过桥米线怎么样', '茶花妹子过桥米线地安门1店怎么样', '茶花妹子过桥米线(地安门1店)怎么样', '茶花妹子过桥米线 北京']
五指生亚运村店	['五指生亚运村店', '五指生亚运村店电话', '五指生亚运村店图片', '五指生亚运村足疗', '五指生亚运村营业时间', '五指生亚运村店价目表', '五指生亚运村店 赵总监']
城市之光5	['城市之光东望', '城市之光楼盘', '城市之光电影', '城市之光卓别林', '心理罪之城市之光', '万科城市之光', '城市之光豆瓣', '城市之光结局', '城市之光香烟价格', '城市之光香烟']
dechuanjia	['德川家康', '德川家', '德川家光', '德川吉宗', '德川家族', '德川家康人物关系图', '德川家日本料理', '德川家茂', '德川家康全集在线阅读', '德川家康名言']
diguashequ	['地瓜社区', '地瓜社区官网', '地瓜社区盈利模式', '地瓜社区现在怎么样了', '地瓜社区 周子书']
交通银行信用卡	['交通银行信用卡', '交通银行信用卡电话', '交通银行信用卡中心', '交通银行信用贷款', '交通银行信用卡提额', '交通银行信用卡申请', '交通银行信用卡年费', '交通银行信用卡电话人工服务热线', '交通银行信用卡积分兑换商城', '交通银行信用卡积分怎么兑换']
shigehuntun	['十个馄饨差不多多少克', '十个馄饨的热量', '十个馄饨', '十个馄饨门头图片', '十个馄饨的热量多少']
mengjizhoupu	['孟记粥铺']
zhangliangmalatang	['张亮麻辣烫', '张亮麻辣烫是谁开的', '张亮麻辣烫加盟费用', '张亮麻辣烫加盟', '张亮麻辣烫加盟费用需要多少钱', '张亮麻辣烫创始人和杨国福', '张亮麻辣烫官网', '张亮麻辣烫老板叫什么', '张亮麻辣烫百度百科', '张亮麻辣烫什么梗']
三泉冷面	['三泉冷面', '三泉冷面望京店', '三泉冷面在北京几家店', '三泉冷面老板是韩国人', '三泉冷面旺角店位置', '三泉冷面新荟城', '三泉冷面加盟电话', '三泉冷面官网', '三泉冷面加盟流程', '三泉冷面简介']
zixiamen	['紫霞门 望京', '紫霞门', '紫霞玫瑰', '紫霞门韩国料理怎么样', '子夏门人问交于子张', '紫霞玫瑰花语', '紫霞门韩国料理电话', '紫霞梦幻飞仙交易', '紫霞门烤肉']
金草帽炭火烤肉店	['金草帽炭火烤肉(东五条路附近)怎么样', '金草帽炭火烤肉怎么样']
Barsak	['barsac', 'barsac贵腐酒', 'barsark', 'barsan', '保安人身安全条例', '保安人身安全知识培训']
坦坦大炉望京店1	['北京坦坦大炉望京店', '坦坦大炉望京店怎么走', '坦坦大炉望京店 团购', '坦坦大炉望京店价格', '坦坦大炉望京店坐什么车']
zhangshifu	['张是非', '张是非的原型', '张师傅加工一批零件,第一天完成', '张师傅脆皮五花肉', '张世峰', '张是非的结局', '张世飞', '张仕福', '张师傅开货车去a城送货', '张氏发源地在哪里']
kaximu	['卡西莫多', '卡西莫多犬', '卡西莫多的礼物', '卡西米尔', '卡西莫多犬多少钱一只', '卡西莫多的礼物歌词', '卡西米', '卡西米尔效应', '卡西莫多人物分析', '卡西姆']
MINGTAIYU1	['明太鱼', '明太鱼干的做法大全', '明太鱼的做法', '明太鱼干', '明太鱼炖豆腐', '明太鱼是什么鱼', '明太鱼汤', '明太鱼热量', '明太鱼是海鱼吗', '明太鱼图片']
裕食坊私家湘菜	['裕食坊私家湘菜怎么样', '裕食坊私家湘菜保利店']
MAZHA-JIUWU	['马扎酒屋']
RYSWJD	['荣耀十忘记密码怎么办', '瑞瑜生物技术有限公司', '容易受外界影响的性格', 'rar压缩文件怎么加密', 'rar压缩文件怎么打开', '如雅商务酒店预订', 'rar压缩文件密码', '润雅商务酒店', 'rar压缩文件设置密码', '日语商务接待用语']
延世医疗	['延世医疗谢树荣', '延世医疗整形美容']
TOMNTOMSCOFFEE1	['tomntomscoffee中文叫什么', 'tomntomscoffee(龙湖时代天街店)怎么样']
lazhuang	['辣庄', '辣庄火锅', '辣庄是包贝尔开的吗', '拉砖车图片', '拉砖电动车', '辣庄加盟费', '辣庄火锅是包贝尔的么', '拉砖拖拉机', '辣庄火锅店加盟费多少', '拉砖图片']
Tianfujiachangcai	['天福家常菜餐馆怎么样', '天福家常菜馆(芙蓉巷店)怎么样', '天福家常菜馆粥·水饺城怎么样']
maxen	['maxence', 'maxell', 'maxen', 'maxell是什么牌子电池', 'maxell是什么牌子', 'maxeye', 'maxed', 'maxence法国男模', '马歇尔', 'maxent']
熔时FIRESIDE	['熔时fireside老板是谁']
MINGTAIYU2	['明太鱼', '明太鱼干的做法大全', '明太鱼的做法', '明太鱼干', '明太鱼炖豆腐', '明太鱼是什么鱼', '明太鱼汤', '明太鱼热量', '明太鱼是海鱼吗', '明太鱼图片']
lvhezi	['lv盒子', 'lv盒子包', 'lv盒子包真假', '闾阖怎么读', '吕和滋源哪个好用', '吕河镇', 'lv盒子包怎么打开', 'lv盒子包掉漆怎么办', 'lv盒子包价格', 'lv盒子包是什么时候出的']
TanTanDaLu	['坦坦大炉', '坦坦大炉五道口', '坦坦大炉加盟', '坦坦大炉顺义店', '坦坦大炉有包间吗', '坦坦大炉优惠券', '坦坦大炉信用卡优惠']
parisbaguette	['parisbaguette价目', 'parisbaguette怎么样', 'parisbaguette 巴黎贝甜月饼', 'parisbaguette官网', 'parisbaguette蛋糕', 'parisbaguette中国官网']
CupOne	['coupon的汉语意思', 'cupone', 'coupon rate', 'coupon怎么读音', 'coupon的意思', 'coupon 翻译', 'coupon是什么意思中文翻译', 'cupon是什么意思', '醋泼尼龙松副作用', 'coupons怎么读音发音']
美都波	['美都能源', '美都西瓜', '美都袋鼠', '美都能源股票', '美都能源股吧', '美都广场', '美都汇', '美都能源连续跌停原因', '美都教育', '美都麒麟瓜']
四季民福wifi	['四季民福wifi密码']
Wanrongxiaochu	['万榕小厨', '万荣小吃一条街在哪', '万荣笑城', '万榕小厨 望京', '万荣笑城生态窑洞住宿怎么样', '万榕小厨商户概况', '万荣小吃街在哪里', '万荣笑城窑洞生态园酒店怎么样', '万荣小吃荞麦饸饹做法', '万荣笑城家宴电话']
yiruntang	['颐润堂望京店', '颐润堂大西洋新城店', '颐润堂正规吗', '颐润堂望京店电话', '易润堂陈皮', '颐润堂王府井', '医润堂魏红卫', '医润堂', '益润堂怎么样', '颐润堂五道口']
剪艺人生－中福	['剪艺人生中福店电话']
huangtucheng	['黄土尘埃已消遁猜一肖', '黄土成语', '皇土成语', '黄土成分', '黄土城', '黄土尘埃', '黄土城火车站', '黄土成因刘东生', '黄土沉香多少钱一克', '黄土城到延庆']
hongjingyu	['洪敬尧', '红景天', '红颈游', '红警尤里的复仇', '弘精用取组成语', '洪敬岩', '鸿景园', '红警尤里的复仇作弊码', '红井源亚麻籽油质量怎么样', '红警语音']
yesido	['yesido翻译中文', 'yesido中文是什么意思', 'yesido是什么歌', 'yesido是什么意思', 'yesido椰岛造型', 'yesidu', 'yesido怎么读', 'yesidid是什么意思', '叶姒的小说全部', '椰丝的做法']
辉佐参鸡汤	['辉佐参鸡汤']
HanTing	['汉庭', '汉庭酒店', '韩童生', '汉庭酒店官网', '寒亭区', '寒亭', '汉庭酒店电话', 'hanting', '汉庭优佳', '汉庭酒店电话400']
寂寞的豆芽	['寂寞的豆芽', '寂寞的豆芽烧烤店', '寂寞的豆芽加盟费多少', '寂寞的豆芽菜单', '寂寞的豆芽官网', '寂寞的豆芽加盟费贵吗', '寂寞的豆芽会员日', '寂寞的豆芽会员日几号', '寂寞的豆芽青岛', '寂寞的豆芽全国分店']
yixuanjiaozi	['一轩饺子馆', '一轩饺子馆 望京', '一轩饺子馆丽都店', '一轩饺子丽都']
Baihualin	['佰华利', '白桦林', '百花缭乱', '白桦林歌词', '白桦林景区', '白桦林溪', '白桦林明天', '白桦林图片', '白桦林居', '白桦林间']
@辉佐参鸡汤	['辉佐参鸡汤']
喜来稀肉	['喜来稀肉', '喜来稀肉官网', '喜来稀肉菜单', '喜来稀肉加盟费多少', '喜来稀肉投诉电话', '喜来稀肉怎么样', '喜来稀肉 太阳的后裔', '喜来稀肉深圳店在哪里', '喜来稀肉全国门店数', '喜来稀肉汉街店电话']
火齐潮汕砂锅粥	['火齐潮汕砂锅粥菜单', '火齐潮汕砂锅粥怎么样', '火齐潮汕砂锅粥加盟费', '北京火齐潮汕砂锅', '火齐潮汕砂锅粥(国贸店)怎么样', '火齐潮汕砂锅粥(木樨园店)怎么样', '火齐潮汕砂锅粥(合生汇店)怎么样', '火齐潮汕砂锅粥价目表', '火齐潮汕砂锅粥(太阳宫凯德店)怎么样', '火齐潮汕砂锅粥(慈云寺店)怎么样']
sijiminfu	['四季民福', '四季民福烤鸭店', '四季民福烤鸭', '四季民福故宫店', '四季民福烤鸭店预约', '四季民福烤鸭店必点菜', '四季民福菜单价格表', '四季民福烤鸭多钱一只', '四季民福烤鸭店故宫店', '四季民福必点菜']
金万享	['金万维', '金万年', '金棘', '京万红', '金棘末', '金万堂', '金万得', '金棘水', '金丙']
xiaoshiguangmang	['消逝光芒', '小时光漫溢芬芳', '消逝光芒怎么扔鞭炮', '小时光漫画', '消逝光芒难度改回普通', '消失光芒怎么才能联机', '消失光芒2什么时候出', '消逝光芒怎么扔k镖', '消失光芒怎么向后滑铲', '消逝光芒复合弩']
黄门老灶火锅	['黄门老灶火锅', '黄门老灶火锅官方网站', '黄门老灶火锅贵不贵', '黄门老灶火锅分店', '黄门老灶火锅(蓝靛厂店)怎么样', '黄门老灶火锅(环亚凯瑟琳广场店)怎么样', '黄门老灶火锅(仙林大学城店)怎么样', '黄门老灶火锅(奥斯卡店)怎么样', '黄门老灶火锅(石佛营店)怎么样', '黄门老灶火锅(顺义怡馨家园店)怎么样']
友佳超市2	['友佳超市(NO.584)怎么样']
新天地KTV	['新天地ktv价格恩施', '新天地ktv门头照']
duolezhiri	['多乐之日', '多乐之日官网', '多乐之日蛋糕', '多乐之日加盟费多少钱', '多乐之日蛋糕订购', '多乐之日蛋糕价格表', '多乐之日招聘', '多乐之日面包', '多乐之日是哪里的品牌', '多乐之日怎么样']
虎千代	['虎千代', '虎和兔', '虎和什么生肖最配', '虎和猴', '虎和牛属相合不合', '虎牙', '虎和虎相配婚姻如何', '虎和羊相配婚姻如何', '虎和猪', '虎和兔合不合适婚姻']
pangzilongxia5	['胖子龙虾', '胖子龙虾马家堡店', '胖子龙虾宋家庄店', '胖子龙虾石景山店电话', '胖子龙虾石景山店', '胖子龙虾万丰路店', '胖子龙虾料', '胖子龙虾 望京', '胖子龙虾北京店', '胖子龙虾海鲜烧烤加盟']
MrPIZZA	['mrpizza', 'mrpizza是什么品牌', 'mrpizza官网', 'mrpizza和必胜客', 'mrpizza是哪里的', 'mrpizza好吃吗', 'mrpizza加盟费多少钱', 'mrpizza加盟费', 'mrpizza投诉电话', 'mrpizza菜单及价格']
kangyunyangsheng	['康云养生堂', '康韵养生会馆正规吗', '康韵养生会馆十里河', '康韵养生会所怎么样', '康韵养生会馆正规不']
多乐之日望京SOHO店	['多乐之日望京soho哪个面包好吃']
逅客民宿	['逅客民宿', '逅客民宿官网']
一个叫川的地方	['一个叫川的地方北京', '一个叫川的地方官网', '一个叫川的地方南昌', '一个叫川的地方谁开的', '一个叫川的地方餐厅', '一个叫川的地方 概况', '一个叫川的地方68折活动怎么算的', '一个叫川的地方望京店', '一个叫川的地方南昌地址']
路边烤牛肉	['路边烤牛排望京店地图', '路边烤牛肉怎么样', '路边烤牛肉(望京店)', '路边烤牛肉.创始怎么样', '路边烤牛肉(望京店)商户概况', '路边烤牛肉(工体总店)怎么样', '路边烤牛肉十里河店', '路边烤牛肉.创始(海淀店)怎么样', '路边烤牛肉望京店']
zhuluchalou	['逐鹿茶楼学院路店', '逐鹿茶楼', '逐鹿茶楼西直门店', '逐鹿茶楼望京', '逐鹿茶楼知春路店', '逐鹿茶楼路六道口', '逐鹿茶楼贵足会正规吗', '逐鹿茶楼明光桥店', '逐鹿茶楼知春路']
TOMNTOMSCOFFEE	['tomntomscoffee中文叫什么', 'tomntomscoffee(龙湖时代天街店)怎么样']
