tangchaoktv	['唐朝', '唐朝皇帝', '唐朝历代皇帝', '汤潮', '唐朝历史', '唐朝好男人', '唐朝地图', '唐朝首都', '唐朝豪放女', '唐朝距离现在多少年']
jindingxuan	['金鼎轩', '金鼎轩菜单', '金鼎轩二公子大凡', '金鼎轩二公子', '金鼎轩地坛店', '金鼎轩菜单及价格', '金鼎轩雍和宫店地址', '金顶鲜胡羊排', '金鼎轩24小时营业', '金鼎轩团结湖店']
zizhuyezonghui2	['紫竹夜总会是干嘛的', '紫竹夜总会洗脸', '紫竹夜总会消费水平', '紫竹夜总会是几百', '紫竹夜总会 北京', '紫竹夜总会 领班', '紫竹夜总会好玩吗']
jiangtaiwuer	['将太无二', '将太无二菜单价目表', '将太无二北京店', '将太无二什么意思', '将太无二菜单', '将太无二什么档次', '姜泰伍', '将太无二是自助吗', '姜太翁钓鱼愿者上钩钓的是谁', '将台湾割让给日本的条约']
Sephora-Guest	['sephora广州店', 'sephora广州哪里有卖', 'sephora官网电话', 'sephora贵吗']
zizhuyezonghui8	['紫竹夜总会是干嘛的', '紫竹夜总会洗脸', '紫竹夜总会消费水平', '紫竹夜总会是几百', '紫竹夜总会 北京', '紫竹夜总会 领班', '紫竹夜总会好玩吗']
北京市党派团体办公楼	['北京市党派团体办公楼', '北京市党派团体办公楼服务管理中心']
MeiNianDaJianKang	['美年大健康', '美年大健康体检中心官网查看报告', '美年大健康体检中心', '美年大健康体检中心报告查询app', '美年大健康体检可信吗', '美年大健康体检中心电话', '美年大健康体检中心怎么样', '美年大健康招聘', '美年大健康体检套餐', '美年大健康体检中心客服电话']
juelvbang	['倔驴帮', '倔驴表情包', '绝缕不如组成语']
lashangyin	['拉伤', '拉伤怎么办', '拉伤肌肉怎样好得快', '拉伤筋的症状', '辣上瘾', '拉伤筋怎么快速恢复', '辣尚宫', '拉伤多久才能恢复', '腊山国家森林公园', '辣上瘾代理']
nongtangli	['脓痰', '弄堂', '浓汤宝', '浓汤', '浓痰是怎样形成的', '弄堂小笼包', '弄堂记忆', '浓汤宝对身体有害吗', '浓痰是风寒还是风热', '浓痰带血']
Tai_Shu_Xi	['泰叔赶海', '泰顺天气', '泰顺天气预报', '泰叔赶海视频', '泰叔赶海百家号', '泰舒达', '泰顺', '泰舒达说明书', '太熟悉家常菜', '泰叔']
yunhaiyao	['云海', '云海金属', '云海玉弓缘', '云海肴', '云海中的风', '云海翻腾孙悟空', '云海山庄', '云海牧鲲', '云海仙踪', '晕海']
yunledi	['云联惠', '云龙', '陨落', '晕轮效应', '云龙湖', '韵律', '云亮', '云南', '云里雾里', '云岭先锋']
shuimumicheng	['水木迷城密室逃脱攻略']
Sizzler	['sizzle', 'sizzler', 'sizzler餐厅', 'sizzix', 'sizzler什么意思啊', 'sizzl', 'sizzurp', 'sizzler是什么菜', 'sizzle it your way', 'sizzler时时乐西餐厅']
hualala-wifi	['哗啦啦外卖怎么关联', '哗啦啦微信公众号', '哗啦啦外卖自提', '哗啦啦舞蹈', '哗啦啦微信', '哗啦啦外卖管理平台', '哗啦啦微信自助点餐', '哗啦啦网页版', '画啦啦网课怎么样', '哗啦啦微信点餐系统']
xizhimenbinguan	['西直门宾馆', '西直门宾馆电话', '西直门宾馆不对外营业', '西直门宾馆地址', '西直门宾馆预定', '西直门宾馆套间价格', '西直门宾馆官方网站', '西直门宾馆附近地铁站', '西直门宾馆 游泳', '西直门宾馆多少钱']
ROUCHUANWANGZONGDIAN	['肉串汪总店怎么样']
tangchaoKTV	['唐朝', '唐朝皇帝', '唐朝历代皇帝', '汤潮', '唐朝历史', '唐朝好男人', '唐朝地图', '唐朝首都', '唐朝豪放女', '唐朝距离现在多少年']
聚点串吧=交大店	['聚点串吧官网', '聚点串吧老板', '聚点串吧张霖简介', '聚点串吧投诉电话', '聚点串吧会员生日半价', '聚点串吧通州店', '聚点串吧 优惠券', '聚点串吧创始人电话', '聚点串吧餐饮公司', '聚点串吧公益西桥']
tpyzq-vip	['太平洋证券', '太平洋证券股票', '太平洋证券2019年中报', '太平洋蒸汽发生器', '太平洋证券大股东', '太平洋证券手续费多少', '太平洋证券是什么等级', '太平洋证券开通创业板', '太平洋证券泰安营业部', '太平洋证券左雪照片']
BJSFRBG	['北京师范大学', '北京师范大学珠海分校', '北京师范大学珠海分校教务管理系统', '北京师范大学研究生院', '北京师范大学法学院', '北京师范大学图书馆', '北京师范大学香港浸会联合国际学院', '北京师范大学本科招生网', '笔架山风景区', '北京市丰台区天气']
wedome-wifi	['wedome味是什么品牌']
gymboree	['gymbo主题曲', 'gymbo系统登录', 'gymbo什么意思', 'gymbo主题曲歌词', 'gymboree', 'gymbo主题曲中文', '金宝贝主题曲gymbo', 'gymbo歌词', 'gymbo英语怎么读']
bianjinggongheguo	['边境共和国(新奥店)', '边境共和国 大众点评', '边境共和国餐厅菜单', '边境共和国(荟聚购物中心)']
HuXiaoShanZhuang~1F	['呼啸山庄', '呼啸山庄简介', '呼啸山庄采用什么叙述方法', '呼啸山庄读后感', '呼啸山庄人物', '呼啸山庄电影', '呼啸山庄经典语录', '呼啸山庄人物关系图', '呼啸山庄好词好句', '呼啸山庄人物分析']
jindingxuan_5g	['金鼎轩', '金鼎轩菜单', '金鼎轩二公子大凡', '金鼎轩二公子', '金鼎轩地坛店', '金鼎轩菜单及价格', '金鼎轩雍和宫店地址', '金鼎轩24小时营业', '金鼎轩团结湖店', '金鼎轩方庄店电话']
