中国联通-鹿港小镇	['中国联通路由器登陆用户名密码', '中国联通路由器设置', '中国联通路由器', '中国联通路由器los亮红灯', '中国联通路由器信号灯', '中国联通逻辑id和密码都是什么']
LunYuCunZhuang.	['轮雨村庄', '轮雨村庄之禁忌游戏', '轮雨村庄(天鹅湾店)怎么样']
AppleStore	['app了store', 'app了store无法连接怎么办', 'app了store无法登录', 'app了store验证码老是白的', 'app了store是什么意思', 'apple store怎么改成中文', 'apple store无法连接', 'apple store无法下载', 'apple store自动扣费', 'app了store打不开']
ChateauStarRiver	['chateaustarriver.com']
QianZiLian-2	['千子莲足道', '千子莲足道有飞机吗', '千子莲', '嵌字联', '嵌字联生成器', '千子莲养生会所燕郊', '千字两百是什么意思', '签字两个字怎么写', '浅紫连衣裙搭配什么包']
qlhk2014	['全力火开2开放城市']
homeinns3	['homeinn', 'homeinn什么意思', 'homeins']
Bankcomm	['bankck', 'bank code什么意思', 'bank充电宝', 'bankcomm.com']
QJD1864	['清洁度111会变严重', '清洁度1到2是什么意思', '清洁度1v正常吗', '请记得1998', '清洁度1234度怎么写的', '千斤顶150吨什么价', '欠京东1500京东要起诉', '缺角的100元可以用吗', '清洁度123哪个严重', '清洁度11度什么意思']
homeinns2	['homeinn', 'homeinn什么意思', 'homeins']
TangGong	['塘沽天气', '糖果', '堂哥', '唐高宗', '唐功红', '唐古拉山', '塘沽', '唐国强', '糖果英文']
chaoyangjianshen	['朝阳建设集团有限公司', '朝阳建设银行', '朝阳健身房月卡价格表', '潮阳建设银行电话', '朝阳健身房', '朝阳建设', '朝阳建市时间', '朝阳建三线是哪到哪', '朝阳健身操第十二套', '朝阳建设银行三燕支行']
jazz.ya	['jazz是什么舞种', 'jazz是什么意思中文翻译', 'jazz舞', 'jazz funk是什么舞种', 'jazzcat舞蹈考级视频', 'jazz rap', 'jazz怎么读', 'jazz分类']
caffebene	['caffe编译matlab接口']
眉州东坡-12	['眉州东坡酒楼', '眉州东坡菜单', '眉州东坡酒楼电话', '眉州东坡集团', '眉州东坡网上订餐', '眉州东坡酒楼菜单', '眉州东坡电话', '眉州东坡官网', '眉州东坡小吃', '眉州东坡门头沟']
CMCC-WEB	['cmcc是什么网络收费吗', 'cmcc通用密码', 'cmcc-tv', 'cmccedu登陆界面网址', 'cmccweb是什么网络', 'cmcc是什么网络', 'cmcc-xj', 'cmcc的wifi密码是多少', 'cmcc-s1']
CU_ziroom	['粗孜然的用法', '醋渍如何清洗']
qianzilianzudao	['千子莲足道', '千子莲足道有飞机吗', '千子莲足道消费价格', '千子莲足浴价格表', '千子莲足道怎么样', '千姿莲足道', '千子莲足疗店', '千子莲足疗会所怎么样', '千子莲足道(金牛街荷塘月色店)怎么样', '千子莲足道(亦庄分店)怎么样']
HUAZHU-Hanting	['华住汉庭优惠券', '华住汉庭', '华住汉庭宁波', '华住汉庭酒店wifi密码', '华住汉庭wifi密码', '华住汉庭酒店数据泄漏', '华住汉庭投诉电话', '华住汉庭电话是多少', '华住汉庭酒店', '华住汉庭官网']
56033657	['560338624042683044', '02131356033', '076982256033', '江诗丹顿756033']
Sephora-Guest	['sephora广州店', 'sephora贵吗', 'sephora广州哪里有卖', 'sephora官网电话']
7daysInn	['7days下载', '7days结局', '7days游戏', '7days游戏攻略', '7days to die', '7days攻略', '7days面膜', '7days歌曲', '7days什么意思']
misshuo	['mission', 'missing', 'miss是什么意思', 'miss you', 'missed', 'missile', 'miss a', 'missing operate system', 'miss you是什么意思', 'miss sixty是什么牌子']
tianehui	['天鹅', '天鹅湖', '天鹅臂', '天鹅堡', '天鹅蛋', '天鹅绒', '天阿降临', '天鹅颈', '天鹅座流星雨', '天鹅简笔画']
LiJiaJia-wifi	['李佳佳微博', '李嘉佳微博']
24小时自助图书馆	['24小时自助银行可以存钱吗', '24小时自助洗车', '24小时自助便利店', '24小时自助图书馆书籍多吗', '24小时自助下单平台', '24小时自助银行可以办卡吗', '24小时自助图书馆', '24小时自助法院', '24小时自助图书馆怎么使用', '24小时自助银行']
红银河wifi	['红银河网吧电话']
JuZiShu_QNL	['桔子树', '桔子树怎么养', '桔子树小说', '桔子树培训中心', '橘子树', '桔子水晶酒店', '橘子树怎么养', '桔子树叶子发黄的原因', '橘子树图片', '橘子树怎么修剪']
chongqingxiaomian	['重庆小面', '重庆小面的做法', '重庆小面加盟店', '重庆小面的做法及配料', '重庆小面图片', '重庆小面培训哪家最好', '重庆小面加盟费多少钱', '重庆小面加盟要多少钱']
jinshoushao	['金手勺', '金寿山', '金首饰', '金首饰怎么清洗才亮', '金首饰价格', '金首饰回收', '金首饰哪个牌子好', '金手勺东北菜', '金寿什么字']
shishangmatou	['时尚买手', '时尚码头', '时尚买手是什么职业', '时尚马尾辫的扎法图片', '时尚码头全国连锁店', '时尚妈妈产后修复加盟', '时尚买手怎么入行', '时尚码头美容美发', '时尚码头北京连锁店']
LunYuCunZhuang2	['轮雨村庄', '轮雨村庄之禁忌游戏', '轮雨村庄(天鹅湾店)怎么样']
MeowCafe	['meow长板', 'meowcon美瞳官网', 'meowcat', 'meow长板到底有多软', 'meow长板是专业板吗', 'meow长板好不好', 'meow长板是专业版吗']
QianZiLian-1	['千子莲足道', '千子莲足道有飞机吗', '千子莲', '嵌字联', '嵌字联生成器', '千子莲养生会所燕郊', '千字两百是什么意思', '签字两个字怎么写', '浅紫连衣裙搭配什么包']
PizzaHut	['pizza怎么读音发音', 'pizza币', 'pizza做法', 'pizza可数吗', 'pizzaisa', 'pizza怎么读', '披萨怎么做', 'pizza游戏', 'pizza hut', 'pizza什么意思']
LunYuCunZhuang3	['轮雨村庄', '轮雨村庄之禁忌游戏', '轮雨村庄(天鹅湾店)怎么样']
.@博成雅居酒楼	['博成雅居酒楼', '博成雅居青年路']
PUPPY_TOWN	['puppy特殊含义', 'puppy图片', 'puppy投影仪官网']
huaniucanguan	['花牛餐馆']
runjiangnan2	['润江南朝阳大悦城店', '润江南', '润江南旅行社', '润江南旅行社怎么样', '润江南 订餐 电话', '润江南倒闭', '润江南热水器', '润江南热水器怎么安装', '润江南餐厅怎么样']
LianJia	['梁舜燕病逝', '联通', '梁朝伟', '李安', '梁博', '联合早报', '连云港', '梁舜燕几岁', '链家', '梁家辉']
Starbucks	['starbur什么品牌', 'starbur', 'starbur是什么意思', '星巴克', 'starbug', 'starbucks', 'star布鞋', 'starbur中文什么意思', 'starbux', 'starbus是什么意思']
bianlifeng	['便利蜂', '便利蜂加盟费多少', '便利蜂官网', '便利蜂招聘', '便利蜂咖啡', '便利蜂工资怎么那么高', '便利蜂连锁便利店', '便利蜂加盟', '便利蜂加盟费', '便利蜂app']
weishiguang	['胃食管反流', '胃食管反流病的症状', '胃食管反流吃什么药', '胃食管反流病怎么治', '为时过早', '胃食管反流怎么冶', '胃食管反流病能治好吗', '胃食管反流病的症状吃什么药', '胃食管反流的治疗', '胃食管反流病能活多久']
Waipojia	['外婆', '外婆家', '外婆菜', '外婆的澎湖湾', '外婆的家', '外婆桥', '外婆周杰伦', '外婆歌词', '外婆英文', '外婆的澎湖湾歌词']
ICBC-WiFi	['icbc网上银行客户端', 'icbc网络金融部八卦', 'icbc网络金融部刘曼', 'icbc网讯', 'icbc网络金融部员工', 'icbc网络金融部事件', 'icbc微信聊天水木', 'icbc微信刘曼', 'icbc温哥华']
BJLYFCYY	['北京淋浴房', '北京旅游服务公司', '北京莱茵服装旗舰店', '补救淋浴房积水的垫子', '北京旅游防晒必备', '北京淋浴房维修电话', '北京六院附近如家', '北京梨园附近商场', '保加利亚房产投资', '北京刘逸夫']
runjiangnan	['润江一号', '润江昆仑府', '润江集团', '润建股份', '润江煦园', '润建股份有限公司', '润江新华壹号院', '润江壹号 开发区', '润江地产石家庄', '润江花苑']
CGB-WIFI	['参观博物馆作文', '村干部为村民干的好事', '村干部违法举报信样本', '参观博物馆的观后感', '参观博物馆的活动成果', '参观博物馆的心德体会', '参观博物馆观后', '彩钢板屋顶防水价格', '参观博物馆', '晨光本味修正带怎么修']
DiaoYeniunan	['雕爷牛腩', '雕爷牛腩失败的原因', '雕爷牛腩创始人', '雕爷牛腩现状', '雕爷牛腩菜单价目表', '雕爷牛业外卖包装', '雕爷牛腩现状2019', '雕爷牛腩创始人陈小春', '雕爷牛腩筷子', '雕爷牛腩外卖图片']
xianaohui	['仙傲', '虾脑', '腺癌', '西安奥特莱斯', '西安奥体中心', '西安奥特莱斯折扣店在哪', '仙傲全文免费阅读', '虾脑可以吃吗', '西安奥体中心在什么地方', '西安奥特莱斯哪家好']
YAN-BOOKS	['严伯钧', '烟波浩渺', '烟波江上使人愁', '烟波浩渺什么意思', '烟波江上使人愁的前一句是什么', '淹脖子', '研钵', '烟波钓叟歌', '岩博酒业', '眼波横by困倚危楼']
BEERALL	['beer是什么意思中文', 'beer怎么读', '贝尔', 'beers', 'bear', 'beer是什么意思', 'bees', 'beef', 'beer pong', 'beer可数吗']
homeinns	['homeinn', 'homie', 'homeie是什么意思', 'homeinn什么意思', '红霉素', 'homeis', 'homein', 'homeic', 'homeins', '红玫瑰']
XuePankaochuan	['薛蟠烤串', '薛蟠烤串 张艺兴', '薛蟠烤串为什么叫薛蟠', '薛蟠烤串老板是谁', '薛蟠烤串官网']
yingpaisijianshen	['英派斯健身', '英派斯健身年卡价格表', '英派斯健身器材', '英派斯健身俱乐部', '英派斯健身价格', '英派斯健身电话', '英派斯健身怎么样', '英派斯健身器材价格', '英派斯健身官网', '英派斯健身年卡多少钱']
xiaojungan	['小郡肝是什么', '小郡肝', '小君', '肖俊', '小欢喜', '萧军', '肖军', '小军鼓', '小君舞蹈秀', '萧敬腾']
北京3Am无痕接发	['北京3am无痕接发']
pinkbaby	['pinkbox', 'pinkbox是什么牌子', 'pinkbox官网', 'linkboy', 'pink包', 'pinkbox国内专柜', 'pinkboy什么意思', 'pinkbox香港专柜在哪里', 'pinkbox金价', 'pinkbox南瓜车']
shunshun	['顺遂', '顺势而为', '顺时针', '瞬时速度', '顺水推舟', '顺手牵羊', '顺颂商祺', '顺时针是什么方向', '顺丰', '顺顺留学']
xiachixiashuan	['虾吃虾涮', '虾吃虾涮的做法', '虾吃虾涮加盟多少钱', '虾吃虾涮加盟', '虾吃虾涮虾火锅', '虾吃虾涮图片', '虾吃虾涮怎么样', '虾吃虾涮菜单', '虾吃虾涮地址', '虾吃虾涮虾火锅加盟费多少钱']
CHAOGuest	['炒股', '炒股软件', '炒股入门', '炒股怎么炒', '炒锅', '炒股养家', '超光速', '炒股开户', '超过', '炒股软件哪个最好']
elephant1	['elephant', 'elephant 怎么读', 'elephant什么意思思', 'elephant儿歌', 'elephant是什么意思', 'elephant bird', 'elephant是什么意思中文', 'elephant in the room', 'elephant音标', 'elephant seal']
shunshun2	['顺势而为', '顺时针', '瞬时速度', '顺水推舟', '顺手牵羊', '顺时针是什么方向', '顺势', '顺势疗法', '顺顺留学', '顺顺']
hanjimmy	['韩佳人', '汉江', '汉江师范学院', '汉景帝', '汉江怪物', '韩剧网', '韩将日本移出白名单', '焊接', '韩剧', '寒噤']
TOKYOJING	['tokyo几好看', 'tokyo简写']
Jasmine	['jasmine', 'jasmin', 'jasmine英文名', 'jasmine flower', 'jasmyn', 'jasmine怎么读', 'jasmine和张艺兴', 'jasmina', 'jasmine即刻电音']
MARTINI	['martin', 'martial', 'martell', 'martini', 'martha', 'marth', 'martyr', 'smart', 'martina', 'martech']
InterContinental	['intercontinental', 'intercontinental洲际酒店', 'intercontinental上海', 'intercontinental hangzhou', 'intercontinental hotel', 'intercontinental hotel上海', 'intercontinental怎么读', 'intercontinental长沙', 'intercontinental广州']
INSTYLE-2	['instyle', 'instyle造型', 'instyle中文是什么意思', 'instyle造型价目表', 'instyle是什么牌子', 'instyle是什么意思', 'instyle创始人', 'instyle造型官网', 'instyle优家画报', 'instyle美发创始人']
云川台球三里屯店	['云川台球三里屯店电话']
walahuoguo	['蛙辣火锅', '蛙辣火锅图片']
1001night	['1001nights', '1001年是什么朝代', '1001年', '1001nights天野喜孝', '1001night', '1001年属什么的', '1001年是什么星座', '1001年出生今年几岁了', '1001年的硬币价格']
ModePlus	['modern', 'modest', 'moderato', 'moderate', 'moder', '抹的拼音', '磨的拼音', '模的拼音', '摸的拼音', '末的拼音']
HomeInns	['homein', 'homeic', 'homie', 'homeinn', '红玫瑰', 'homeis', 'homeie是什么意思', 'homeins', 'homeinn什么意思', '红霉素']
WX-dadong	['无心的爱电视剧全集', '无锡娣安娣', '文胸的abcd代表什么', '五险档案丢失怎么补', '微信档案打不开怎么办', '文胸的abc的区别图片', '无线电aprs地图', '无锡东安电子有限公司', '我想对安迪一家说的话']
BRACKET	['bracelet', 'bracket', 'braces', 'brack', 'bracing', 'bracca', 'branch', 'bracelet是什么意思']
Moonshine	['moonshine', 'moon是什么意思', 'moon神', 'moonshine是什么意思', 'moon是谁', 'moon是什么意思中文', 'moon是什么意思中文翻译', 'moon是什么牌子', 'moonshine conjecture', 'moonshine valley']
sanfulong	['sanfu轮胎', '三伏烙饼摊鸡蛋', '三福里面的化妆品是正品吗', '三伏里面加一秋是什么意思', '三抚林场', '三福龙景 福清', '三伏烙饼摊鸡蛋怎么做', '三伏立秋', '三伏里几伏最热', '三伏烙饼摊鸡蛋图片']
rongshangzaoxing_5G	['融尚造型', '融尚造型(工体北路一店)怎么样', '融尚造型(工体北路一店)', '融尚造型(工体北路一店) 评论', '融尚造型(工体北路二店)怎么样']
HaiDiLaoHuoGuo	['海底捞火锅加盟', '海底捞火锅底料', '海底捞火锅加盟费多少', '海底捞火锅价格表', '海底捞火锅怎么样', '海底捞火锅蘸料怎么配', '海底捞火锅', '海底捞火锅学生证69折时间', '海底捞火锅成立时间', '海底捞火锅图片高清']
NiaoTun	['尿毒症', '尿酸高', '尿酸', '鸟巢', '尿路感染', '尿蛋白', '尿素', '尿道炎', '尿素现货价格', '尿血']
shijiajingpin	['世嘉经典游戏', '十加井去掉一个横', '石加经的右边', '史家精神', '试驾晶锐', '世嘉近光灯泡更换教程', '世嘉经济模式解除方法', '世嘉近光灯怎么换', '十佳警察', '石家金谷从新声']
hongyitang_1f	['弘医堂', '弘医堂中医院', '弘医堂中医院怎么样', '弘医堂夏梦', '弘医堂中医院电话', '弘医堂耳鼻喉研究院怎么样', '宏医堂', '宏易堂', '弘医堂 温仕德', '洪姨糖水可以加盟吗']
yanweidie	['晏维', '阎维文', '燕尾服', '燕尾蝶', '严为民', '燕尾夹', '燕尾', '燕尾模型', '盐味奶糖', '烟味']
中国联通-D-one	['中国联通dns地址', '中国联通短信查询套餐', '中国联通电话套餐查询', '中国联通打多少查话费', '中国联通代码是多少', '中国联通电话祥单查询', '中国联通的猫怎么设置', '中国联通党组2019 1号', '中国联通的代理端口', '中国联通定制号码']
xiaohongpaoS	['小红瓶', '小红瓶丰胸真的有用吗', '小红瓶sk2', '小红瓶精华', '小红瓶使用方法', '小红袍', '小红瓶是什么', '小红瓶和小灯泡哪个好', '萧鸿鹏', '小红袍龙虾馆']
hooters1	['hooters', 'hooted', 'hooters餐厅', 'hooters猫头鹰餐厅', 'hootenanny', 'hotel', 'hooters是什么意思', 'hooters北京停业', 'hooted怎么读', 'hooter和horn的区别']
alexbros	['alex博客', 'alex博士bbc发音宝典', 'alex本周运势', 'alex白羊座8月运势', 'alex白羊座2019年运势', 'alex波动大招', 'alex本周星座运势', '阿拉尔西北兴业', '奥莱尔x1s 2020版']
shuilintianyue	['水临天玥歺牌价格']
CHAOPublic	['超溥避孕套有什么品子', '超溥不锈钢溥', '超溥冰箱厚度连门57cm', '超溥避孕套有什好处', '超溥笔记本的选择']
hongyitang_2f	['弘医堂', '弘医堂中医院', '弘医堂中医院怎么样', '弘医堂夏梦', '弘医堂中医院电话', '弘医堂耳鼻喉研究院怎么样', '宏医堂', '宏易堂', '弘医堂 温仕德', '洪姨糖水可以加盟吗']
SIR.TEEN	['sir.teen', 'sirteen酒吧', 'sirt1', 'sirtuin', 'sirteen散客门票', 'sirt3', 'sirtex', 'sirt6', 'sirteen翻译中文', 'sirts']
bluefrog	['blued', 'bluefish', 'bluefin', 'bluefly什么意思', 'bluefox', 'bluefin tuna', 'bluefly官网', 'blue翻译', 'blue发音', 'blue翻译成中文是什么']
MCD-ChinaNet	['mcd-chinanet']
lantern	['兰亭序', '兰亭集序', '蓝天白云', '蓝天', '蓝图', '蓝田玉', '兰太实业', '兰亭', '蓝田']
nakedhub	['那刻的怦然心动', '那刻的怦然心动电视剧免费观看', '那刻的怦然心动演员表', '那刻的怦然心动在哪个台播', '那刻的怦然心动百度云']
xiaogechuanchuan	['小哥串串香(三里屯店)怎么样', '小哥串串香(银河SOHO店)怎么样', '校歌传唱活动总结', '小哥串串香(回龙观店)怎么样', '小哥串串香怎么样', '校歌传唱比赛宣传创意', '小哥串串香(金源店)怎么样']
dipingxian	['地平线', '地平线4', '地平线3', '地平线摩托车', '地平线零之曙光', '地平线4手机版下载', '地平线公司', '地平线机器人', '地平线英文', '地平线2']
MokaBros	['mokabar', '摩卡波波头短发造型', '摩卡波波头图片', '摩卡波波头', '魔卡百科', '摩卡冰的好喝还是热的', '摩卡波波头适合什么脸型', '摩卡杯', '摩卡贝贝', '摩卡冰沙']
republic_5G1	['republic of korea', 'republic of china什么意思', 'republic什么意思', 'republic of game', 'republic怎么读', 'republic是哪个国家', 'republican party', 'republic of singapore', 'republication', 'republican什么意思啊']
WXmatsuko	['微信卖阿瞳是真是假']
elephant	['elephant', 'elephant 怎么读', 'elephant什么意思思', 'elephant儿歌', 'elephant是什么意思', 'elephant是什么意思中文', 'elephant in the room', 'elephant音标', 'elephant seal', 'elephant怎么读 英语怎么读']
niaotun	['尿毒症', '尿酸高', '尿酸', '鸟巢', '尿路感染', '尿蛋白', '尿素', '尿道炎', '尿素现货价格', '尿血']
toastbar	['toaster', 'toastmaster', 'toast是什么意思中文', 'toast分型', 'toast怎么读', 'toasty', 'toast box', 'toast通知', 'toastie', 'toast bread']
Cleopatra	['cleopatra']
shangbangdaisi	['上邦戴斯精品酒店', '上邦戴斯酒店网评', '上邦戴斯', '上邦大国', '上邦戴斯酒店', '商帮大量出现在']
马路牙子地桌烤肉5G	['马路牙子地桌烤肉加盟', '马路牙子地桌烤肉(工体店)怎么样', '马路牙子地桌烤肉望京店', '马路牙子地桌烤肉(工体店) 概况', '马路牙子地桌烤肉(工体店)商户概况', '马路牙子地桌烤肉(工体店)用户评论', '马路牙子地桌烤肉密码']
Playhouse	['playhouse', 'playhouse酒吧', 'playhouse什么意思', 'playhouse成都', '家族崩坏', 'playhouse长沙', 'playhouse成都王嘉尔', 'playhouse什么意思中文翻译', 'playhouse酒吧长沙', 'playhouse酒吧中文怎么读']
中国联通-Lugas	['中国联通路由器登陆用户名密码', '中国联通路由器设置', '中国联通路由器', '中国联通路由器los亮红灯', '中国联通路由器信号灯', '中国联通逻辑id和密码都是什么', '中国联通乱扣费怎么办', '中国联通逻辑id是什么', '中国联通乱扣流量', '中国联通路由器los灯']
DLOUNGE	['顶楼的大象', '顶楼大象', 'dloua', 'dlouyf', 'dlouse怎么读', 'dlouyf是什么牌子', 'dlou教务系统', 'dlouyf是什么牌子香水']
xiaochunrihe	['小春日和', '小春日和露丝猫', '小春日和 露娜猫微盘', '小春日和露丝猫百度云', '小春日和 露娜猫txt', '小春日和露丝猫书包', '小春日和txt.百度云', '小春日和是什么意思', '小春日和露娜猫免费']
haidilaoPOS	['海底捞', '海底捞会员', '海底捞火锅', '海底捞菜单', '海底捞电话', '海底捞老板', '海底捞上市', '海底捞消费', '海底捞外卖', '海底捞加盟']
Knight魔术酒吧	['knight魔术酒吧']
republic	['republic', 'republic of korea', 'republic of china什么意思', 'republic什么意思', 'republic of game', 'republication', 'republic怎么读', 'republic of singapore', 'republic mexican银币', 'republic of indonesia']
huangmen	['黄子韬恋情疑曝光', '黄磊', '黄历', '黄晓明', '黄金价格', '黄渤', '黄山', '黄鹤楼', '黄金']
Scandal	['scanner', 'scanf', 'scan是什么意思车上的', '斯堪尼亚', 'scan是什么意思', 'scans', 'scanf函数', 'scandalous', 'scanpay']
BOTTEGA	['bottle', 'bottom', 'bottles', 'botton', 'bottega是什么牌子', 'bottle怎么读', 'botter', 'bottom是什么意思中文翻译', 'bottleneck', 'botte']
jinguixiaoshancheng	['金簋小山城', '金簋小山城牛蛙', '金簋小山城 春秀路', '金簋小山城分店电话', '金簋小山城(亚运村店)怎么样', '金簋小山城(亚运村店)', '金簋小山城(南湖东路店)怎么样', '金簋小山城(簋街一店)怎么样', '金簋小山城加盟费多少', '金簋小山城(秦皇大街店)怎么样']
zhanhouse	['战后之战', '战吼萨', '展红绫', '展鸿', '战吼', '藏红花', '詹宏志', '战洪州', '战后余温', '战后创伤综合症']
SANFINE_HOSPITAL	['sanfinehospital']
Glen_free	['glenfid威士忌', 'glenfid', 'glenfid威士忌18', 'glenfid威士忌12', 'glen翻译', 'glenfdd']
ONETHIRD	['one third酒吧', 'onethor电饭煲怎么用', 'onethe地球', 'onethe序数词', 'coneth']
IBIZA-B3	['ibiza绝地求生', 'ibiza微博', 'ibiza耳机', 'ibiza虎牙', 'ibiza是谁', 'ibiza直播', 'ibiza 西班牙', 'ibiza灵敏度', 'ibiza设置', 'ibiza liquid']
为美好相聚沸腾	['为美好相聚沸腾']
bajianchuan	['拔剑吃醋', '拔剑吃醋什么梗', '拔剑出鞘', '拔剑成语', '拔剑吃醋魔道祖师', '拔剑出鞘的意思', '把坚持和加强党的', '把检察建议做成刚性', '巴尖串串加盟', '八坚持八反对']
tongxinge	['同性恋', '通信工程', '桐乡', '童星', '通心粉', '童小华最新进展', '佟湘玉', '同性', '童心']
yuxin1997	['余新172公交站点']
yuebeixiaocheng	['粤北小城法人', '粤北小吃炸萝卜糍', '粤北小城(三里屯世茂店)怎么样', '粤北小城世贸百货店怎么样', '粤北小城(世贸百货店)', '粤北小城·潮汕砂锅粥怎么样', '粤北小厨商户概况']
Berko-1	['berkeley', 'berklee', 'berkshire', 'birkin', 'berko', 'berlin', 'berluti', 'berkeley大学', 'berker', 'berke']
night1001	['night11.icu', 'night1.top', 'night12.icu']
HighTown	['hight什么意思', 'height', 'high歌', 'hightea', 'highlight', 'higher', 'hightly', 'highten', 'hightc', 'highest']
三公潮汕牛肉火锅1	['三公潮汕牛肉火锅三里屯店', '三公潮汕牛肉火锅', '三公潮汕牛肉馆怎么样', '三公潮汕牛肉火锅三里屯']
GoodBait	['goodbye', 'goodbye是什么意思中文', 'goodboy舞蹈视频原版教学', 'goodbye song', 'goodby2', 'goodby', 'goodbye my lover', 'goodbye summer', 'goodboy什么意思', 'goodboy音乐']
shunshun_5G	['顺顺', '顺顺留学', '顺顺利利', '顺顺电影', '顺顺儿', '顺顺当当', '顺顺溜溜的意思', '顺顺利利图片', '顺顺利利的数字红包', '顺顺丰快递单号查询']
HUAXING_GUEST	['华星光电', '华星光电招聘', '华星光电股票', '华星光电怎么样', '华星光电是国企吗', '华星国际影城', '华星国际影城双安店', '华星光电有限公司', '华星股票', '华星光电和tcl的关系']
ANCHOR-0	['anchorage', 'anchor是什么意思中文', 'anchovy', 'anchor奶粉怎么样', 'anchor point', 'anchoret', 'anchor free', '安重根', 'anchor是什么意思中文翻译', 'anchor音乐']
THESECRET	['these词性', 'the second', '泰禾二十二城四十四院']
FOURACE	['fourth', 'fourteen什么意思', 'fourze', 'four lock', 'fourth怎么读', 'four的同音词', 'four什么意思', 'fourier', 'fours']
RestaurantY	['restaurant', 'restaurant怎么读', 'restaurant怎么读英语', 'restaurant 是什么意思', 'restaurateur', 'restaurant的中文意思是什么', 'restaurant是什么意思中文', 'restaurant是什么意思中文翻译', 'restaurant怎么读音发音', 'restaurant的音标']
Shuilintianyue	['水临天玥歺牌价格']
SWING58	['swing', 'swine', 'swings', 'swing什么意思', 'swim', 'swins', 'swin组合', 'swing怎么读', 'swing dance', 'swimming']
instyle	['instead', 'instrument', 'instant', 'instruction', 'instance', 'instruct', 'instinct', 'institution', 'instagram.com', 'instructor']
lantern03	['lantern读音', 'lantern festival']
hongyitang_n2	['弘医堂', '弘医堂中医院', '弘医堂中医院怎么样', '弘医堂夏梦', '弘医堂中医院电话', '弘医堂耳鼻喉研究院怎么样', '宏医堂', '宏易堂', '弘医堂 温仕德', '洪姨糖水可以加盟吗']
Buerjiuguan	['不二酒馆怎么样', '不二酒馆斯斯与帆']
pintec-guest	['pintec股价']
REDREAM	['redrum', 'redress', 'redraw', 'redream', 'redrum是什么意思', 'redrock', 'redrose', 'red', 'reds', 'redrawn']
BaseFit	['based', 'basement', 'base是什么意思', 'base on', 'baseline', 'baseus', 'basel', 'bases']
YingLanQuanXi	['英澜全屋定制怎么样', '樱兰全息养生馆正规吗', '樱兰全息养生馆怎么样']
INSTYLE1	['instyle', 'instyle造型', 'instyle中文是什么意思', 'instyle造型价目表', 'instyle是什么牌子', 'instructor', 'instyle创始人', 'instyle是什么意思', 'instyle优家画报', 'instruction']
WandaMedia	['万达美食广场', '万达美食', '万达美华酒店', '万达门票多少钱一张', '万达美食攻略', '万达美华', '万达美食排行', '万达门面租金', '万达门票学生多少优惠吗', '万达萌宠乐园']
马路牙子地桌烤肉	['马路牙子地桌烤肉加盟']
instyle02	['instyle', 'instyle造型', 'instyle中文是什么意思', 'instyle造型价目表', 'instyle是什么牌子', 'instyle是什么意思', 'instyle创始人', 'instyle造型官网', 'instyle优家画报', 'instyle美发创始人']
PortalCafe	['portal传送门']
OneThird	['one third酒吧', 'onethor电饭煲怎么用', 'onethe地球', 'onethe序数词', 'coneth']
bianyifang	['便宜坊', '便宜坊烤鸭', '便宜坊怎么读', '便宜坊烤鸭店', '便宜坊烤鸭多少钱一只', '便宜坊烤鸭和全聚德烤鸭的区别', '便宜反义词', '便宜坊烤鸭店总店地址', '便宜坊烤鸭价目表', '便宜坊总店']
xiaozhang	['肖战敷眼膜现身', '肖战', '小猪佩奇', '小猪', '小猪佩奇动画片全集', '小丈夫', '小智', '肖战图片', '肖战 顾医生', '孝庄']
HUAXING	['华夏银行', '化学', '华西村', '化学元素周期表', '华胥引', '华夏幸福', '华夏图腾', '华夏航空', '华夏保险', '华西医院']
rongshangzaoxing	['融尚造型', '融尚造型(工体北路一店)怎么样', '融尚造型(工体北路一店)', '融尚造型(工体北路一店) 评论', '融尚造型(工体北路二店)怎么样']
AC-Tattoo	['艾草堂艾条价格表']
SLOWBOATBREWERY	['slowboatbrewery']
WX-D-one	['我修的可能是假仙', '我想当巨星', '卫星地图', '微信贷款', '我行都在简斋诗作者', '卫星地图高清', '微信定位怎么设置', '微信多开', '无限动漫', '晚霞的诗']
dongfangliang	['东方丽人', '东方快车谋杀案', '东方六加一开奖号码', '东方联盟', '东方快车', '东方丽都', '东方亮彩精密技术有限公司', '东方丽人模特空乘学校', '东方列车谋杀案', '东方丽景']
Wolfgang1	['wolfgang', 'wolfgang puck', 'wolfgang牛排', 'wolfgang什么意思', 'wolfgang是谁', 'wolfgang puck是谁', 'wolfgang see', 'wolfgang眼镜', 'wolfgang austria', 'wolfgang超感']
dazhangfu	['大张伟', '大丈夫', '大张伟老婆', '打仗', '大掌门', '大展宏图', '大掌柜', '大展鸿图', '大张高铁', '大蟑螂']
shaoxiashi	['邵夏', '少先队员', '烧仙草热量', '烧香', '烧仙草', '烧仙草图片', '少校', '哨向', '少小离家老大回', '烧香图解']
Caffebene	['caffe编译matlab接口']
ShiTangZui	['石塘', '食堂', '食堂菜谱', '石塘镇', '食堂承包', '食堂英文', '食堂包子', '丝瓜', '食堂标语', '食堂故事']
3am-2-4	['3am美发', '3am美发创始人介绍', '3am美发简介', '3am什么意思', '3am美发价格', '3am智超介绍', '3am理发店', '3am歌曲', '3am大东微博', '3am是什么']
京客隆微信支付	['京客隆微信公众号']
aojiameishuguanjiudian	['奥加美术馆酒店电话', '奥加美术馆酒店美女价格', '奥加美术馆酒店-地面停车场怎么样', '奥加美术馆酒店董事长李', '奥加美术馆酒店为何小姐多', '奥加美术馆酒店地铁能到吗', '奥加美术馆酒店饭菜怎样?', '奥佳美术馆酒店怎么座地铁', '奥加美术馆酒店属于几环']
sushitong	['苏式汤面', '苏诗丁', '苏轼题西林壁诗句', '素食图片', '素食汤的做法大全', '素食图片大全高清图片', '苏式汤面做法', '素士剃须刀怎么样', '粟氏天府', '苏式汤面红汤底的做法']
hooters2	['hooters', 'hooted', 'hooters餐厅', 'hooters猫头鹰餐厅', 'hootenanny', 'hotel', 'hooters是什么意思', 'hooters北京停业', 'hooted怎么读', 'hooter和horn的区别']
rampage	['tramp', 'rampage', 'rampant', 'ramps', 'rampart', 'ramping', 'rampant什么意思', 'rampo', 'ramp什么意思', 'ramped']
moonshine_free	['moonshine翻译中文']
middle8th	['middle school', 'middle怎么读', 'middle是什么意思中文', 'middle name', 'middle east', 'middle class', 'middleware', 'middle of', 'middleman', 'middle ground']
bookworm	['bookworm', 'bookworm是什么意思啊', 'book week', 'bookworm怎么读', 'bookworm beijing', 'bookworm官网', 'bookworm oxford', 'bookworm是个贬义词吗', 'bookworm书虫系列', 'book完成时']
instyle2	['instyle', 'instyle造型', 'instyle中文是什么意思', 'instyle造型价目表', 'instyle是什么牌子', 'instructor', 'instyle创始人', 'instyle是什么意思', 'instyle优家画报', 'instruction']
HUAZHU_Hanting	['华住汉庭投诉电话', '华住汉庭', '华住汉庭优惠券', '华住汉庭宁波', '华住汉庭酒店wifi密码', '华住汉庭酒店数据泄漏', '华住汉庭wifi密码', '华住汉庭电话是多少', '华住汉庭酒店', '华住汉庭官网']
HaiDiLaoDianCai	['海底捞店长助理的要求', '海底捞店助', '海底捞店长杨丽娟事件', '海底捞店长收入', '海底捞电话订餐', '海底捞电话预约', '海底捞店', '海底捞点菜攻略', '海底捞电话', '海底捞点菜攻略2人']
SPACEONE	['spacex', 'space酒吧', 'spaceship', 'space是什么意思', 'spacecraft', 'spaceman', 'space club', 'spacer', 'space fm']
Algorithm	['algorithm', 'algorithmic', 'algorithm是什么意思', 'algorithm函数', 'algorithm翻译', 'algorithm头文件', 'algorism', 'algorithmic trading', 'algorithm negotiation fail', 'algorithm怎么读']
haolinju	['好利来', '好了歌', '号令天下', '好利来蛋糕', '豪利时', '好利来老板', '好利来官网', '豪力', '好丽友', '好邻居']
F-SPACE	['防晒喷雾可以带上飞机吗', '防晒喷雾可以带上高铁吗', '防晒喷雾', '防晒喷雾可以托运吗', '防晒喷雾可以带上火车吗', '防晒喷雾哪款好用', 'fspr手术', 'fsp电源', '粉色配什么颜色好看', '防晒喷雾排行榜']
buerjiuguan2	['不二酒馆怎么样', '不二酒馆斯斯与帆']
wangjingxiaoyao	['望京小腰加盟多少钱', '望京小腰图片', '望京小腰是什么腰子', '望京小腰做法', '望京小腰总店在哪', '望京小腰', '望京小腰怎么样', '望京小腰哪家是真的', '望京小腰总店', '望京小腰加盟']
cafeflo	['cafeteria', 'cafe怎么读', 'cafe是什么意思中文', 'cafes', 'cafe什么意思', 'caffe', 'cafe racer', '咖啡遇上香草', 'cafe法语', 'cafe150']
WX-Hatsune	['我喜欢安徒生的童话']
Mojitoman	['mojito是什么', 'mojito鸡尾酒', 'mojito怎么发音', 'mojito烟', 'mojito做法', 'mojito多少度', 'mojito热量', '莫吉托', 'mojito怎么调', 'mojito度数']
yinyuetai.com	['音悦tai苹果版下载', '音悦tai', '音乐胎教一次多久', '音乐太阳咪咪笑教案', '音悦台怎么买实体专辑', '音悦台下载失败', '音乐胎教100首', '音悦台怎么收费了', '音乐胎教时间', '音乐台推荐是什么意思']
Revolution5G	['revolution', 'revolutionary', 'revolution吉他网易云', 'revolution吉他音频', 'revolution one', 'revolution指弹mp3', 'revolution法国品牌', 'revolution指弹教学', 'revolution桃花妆教程', 'revolution吉他谱']
thebell	['thebes', 'then', 'theboyz组合', 'theboy', 'thebest', 'theboys舞蹈视频', 'thebez手表是什么牌子', 'the best is for you什么意思', 'thebay', 'theboys组合成员']
LaSocial	['lasocki鞋子', 'lasocki品牌']
Revolution	['revolution', 'revolutionary', 'revolute', 'revolution吉他谱', 'revolution是什么意思', 'revolution指弹教学', 'revolution吉他网易云', 'revolution吉他音频', 'revolution one', 'revolution指弹mp3']
DOKOBAR	['dokota', 'doko口红', '豆蔻', 'dokoso钢琴', 'daoko', 'dokomi', 'do口红多少钱一只', 'do口红', 'dokoso', 'dokoso是什么钢琴']
yigonglihaixianfang	['一公里海鲜坊商户概况', '一公里海鲜坊用户评论', '一公里海鲜坊网友评论']
珍滋味港式粥火锅	['珍滋味港式粥火锅菜单', '珍滋味港式粥火锅(工体店)', '珍滋味港式粥火锅加盟', '珍滋味港式粥火锅(新源西里店)怎么样', '珍滋味港式粥火锅官网', '珍滋味港式粥火锅怎么样', '珍滋味港式粥火锅(工体店)商户概况', '珍滋味港式粥火锅价格']
STAFOOD	['staff', 'staff是什么意思中文', 'staffer', 'stafe', 'stage', 'stadium', 'stuff', 'stand', 'staff复数', 'staff怎么读']
lantouzi-guest	['懒投资官方网站', '懒投资官网登录']
rich-healthcare	['rich-healthcare.', 'rich-healthcarecm', "rich-healthcarecom~911100560120一395E'"]
didiao2	['滴滴新规则公示', '滴滴', '滴滴客服', '低调组合', '滴滴代驾', '敌敌畏', '滴滴出行', '滴滴被罚550万元', '滴滴打车', '低调看']
PizzaNow	['pizza怎么读音发音', 'pizza hut', 'pizza什么意思', 'pizza怎么读', 'pizza做法', 'pizza游戏', '披萨怎么做', 'pizzaisa', 'pizza币', 'pizza可数吗']
HolidayInn	['holiday什么意思', 'holiday inn', 'holiday怎么读', 'holiday inn假日酒店', 'holiday inn express', 'on holiday', 'holiday复数', 'holidaymaker', 'holiday可数吗']
Jindingxuan	['金鼎轩', '金鼎轩菜单', '金鼎轩二公子大凡', '金鼎轩二公子', '金鼎轩地坛店', '金鼎轩菜单及价格', '金鼎轩雍和宫店地址', '金顶鲜胡羊排', '金鼎轩24小时营业', '金鼎轩团结湖店']
jindingxuan	['金鼎轩雍和宫店地址', '金鼎轩二公子', '金鼎轩菜单', '金鼎轩地坛店', '金鼎轩', '金顶鲜胡羊排', '金鼎轩24小时营业', '金鼎轩菜单及价格', '金鼎轩团结湖店', '金鼎轩二公子大凡']
xiaotudou...	['小土豆', '小土豆的做法', '小土豆怎么做好吃', '小土豆去皮', '小土豆咸菜的做法', '小土豆奶瓶怎么样', '小土豆咸菜', '小土豆英文', '小土豆nba', '小土豆是谁']
qiaowaipo	['乔万尼', '侨外移民', '乔瓦尼', '乔晚晚陆湛深最新节章', '乔万旭', '敲碗', '翘望', '乔瓦尼欧祖拉', '桥湾', '乔婉']
zhengyuanyuan	['郑远元', '郑媛媛', '郑远元专业修脚房', '郑远元专业修脚房加盟', '郑远元治灰指甲真实吗', '郑远元专业修脚房附近', '郑远元专业修脚房怎么样', '郑远元修脚房价格表图', '郑远元专业修脚店', '郑媛元']
@百万庄园方庄店	['康百万庄园', '百万庄园汉堡', '百万庄园地址', '百万庄园官网', '百万庄园三明治不卖了', '百万庄园知春路店', '百万庄园回龙观店地址', '百万庄园写字楼出租', '百万庄园投资有限公司', '百万庄园 北京海淀']
bingchengBBQ1	['槟城壁画', '槟城壁画街地址', '秉承不忘初心牢记使命', '槟城壁画街', '槟城白咖喱面', '槟城白咖啡怎么样', '槟城壁画地图', '冰城堡的英文', '槟城壁画集中在哪里', '槟城百度百科']
xiaotudou..	['小土豆', '小土豆怎么做好吃', '小土豆的做法', '小土豆nba', '小土豆咸菜的做法', '小土豆奶瓶怎么样', '小土豆怎么去皮', '小土豆隔扣奥尼尔视频', '小土豆奶瓶', '小土豆的做法大全家常']
一汽丰田北京方庄店	['一汽丰田北京所有4s店', '一汽丰田北京总部', '一汽丰田北京华通特约店二手车中心怎么样', '一汽丰田北京销售公司', '一汽丰田北京现代', '一汽丰田北京三元桥店', '一汽丰田北京办事处', '一汽丰田北京总代理', '一汽丰田北京公司', '一汽丰田北京销售']
味多美刘家窑地铁店	['味多美刘家窑店电话', '味多美刘家窑地铁店', '味多美刘家窑电话', '味多美刘家窑营业时间', '味多美刘家窑苏宁店', '味多美刘家窑苏宁']
BEIJING-SHINDOM	['北京市内景点', '北京是哪个省', '北京室内好玩的地方', '北京室内禁烟', '北京是南方还是北方', '北京室内游乐场', '北京室内水上乐园有哪些', '北京是哪个省的城市', '北京市内好玩的景点', '北京市农林科学院']
LAOBAOSAN	['老鸨', '劳保', '劳保用品', '劳保鞋', '老爆三', '老鸨子', '劳保手套', '劳保费', '老鸨的意思是什么', '劳保服']
dawanju	['达瓦', '大王卡', '达瓦更扎', '大湾区', '大王饶命', '大碗宽面', '大王', '大腕', '大玩家', '大王蛇']
Yoshinoya	['yoshino', 'yoshi能日吗', 'yoshino号巡洋舰', 'yoshin 视频', 'yoshino日语是什么', 'yoshino是什么意思', 'yoshino巡洋舰', 'yoshino吉野', 'yoshino战舰世界', 'yoshin快乐大本营']
ChunBingKaoYaDian	['春饼烤鸭店顺三条', '春饼烤鸭店(刘家窑顺三条店)怎么样', '春饼烤鸭店(刘家窑顺三条店)', '春饼烤鸭店推荐顺四条', '春饼烤鸭店刘家窑店', '春饼烤鸭店的电话号码?', '春饼烤鸭店(方庄店)怎么样']
Laochengyiguo	['老诚伊', '老城一锅', '老城一锅羊蝎子', '老城一锅羊蝎子加盟', '老城一锅羊蝎子火锅加盟费多少', '老诚一锅羊蝎子', '老城一锅羊蝎子做法', '老诚一锅和老城一锅', '老诚一锅羊蝎子加盟费多少', '老诚一锅羊蝎子火锅加盟']
ZGGJWJY	['中国国家博物馆', '中国国际航空', '中工国际', '中国国际航空公司', '中钢国际', '中国国籍', '中国国家地理', '中国国家图书馆', '中国国际旅行社', '中国国际能源']
HaiYinHaiJi	['海银海记', '海银海记潮汕火锅', '海银行', '海银行所有网点', '海银行信用卡', '海银海记菜单', '海银韩芳', '海银海记电话', '海银海记深圳旗舰店', '海银海记牛肉']
7daysinn	['7days游戏攻略', '7days to die', '7days结局', '7days面膜', '7days下载', '7days歌曲', '7days游戏', '7days攻略', '7days什么意思']
Sinopec	['sinopec', 'sinoc', 'sinopec是什么意思', '希努尔', 'sinobi', 'sinomax', 'sinofsx', 'sinobi手表是什么牌子', 'sinoc币', 'sinology']
北京何所有酒店	['北京何所有酒店电话', '北京何所有酒店刘家窑', '北京何所有酒店怎么样', '北京何所有酒店地址', '北京何所有酒店 几星']
bingchengBBQ	['秉承', '槟城', '冰城', '饼铛', '病程', '秉承是什么意思', '冰城串吧', '冰城是哪个城市', '病程记录', '秉承着']
dinghaishenzhen	['定海神针', '定海神珍', '定海神针清屏专用超长', '定海神针刷屏', '定海神针比喻什么意思', '定海神针是成语吗', '定海神针图片', '定海神针软件', '定海神珠', '定海神针是什么意思']
julongwatankaoyangtui1	['聚龙娃炭烤羊腿(平谷店)(平谷店)怎么样', '聚龙娃碳烤羊腿城外城店', '聚龙娃炭烤羊腿(临江店)怎么样', '聚龙娃炭烤羊腿(京东旗舰店)怎么样', '聚龙娃碳烤羊腿(刘家窑店)商户概况', '聚龙娃炭烤羊腿京东旗舰店怎么样', '聚龙娃碳烤羊腿(机场店)怎么样', '聚龙娃炭烤羊腿(郑州总店)怎么样']
fengmaokaochuan-2	['丰茂烤串', '丰茂烤串加盟', '丰茂烤串官网', '丰茂烤串加盟费多少钱', '丰茂烤串全国分店地址', '丰茂烤串总店', '丰茂烤串加盟官网', '丰茂烤串电话', '丰茂烤串冬天店内经营视频', '丰茂烤串加盟费多少']
5G_高兴一锅	['5g高通和华为谁赢了', '5g高通', '5g高速公路', '5g高通华为', '5g高通芯片联想首发', '5g高通芯片', '5g高铁', '5g高带宽', '5g高清视频股票', '5g高速流量是什么意思']
fengmaokaochuan_5G	['丰茂烤串', '丰茂烤串加盟', '丰茂烤串官网', '丰茂烤串加盟费多少钱', '丰茂烤串全国分店地址', '丰茂烤串总店', '丰茂烤串加盟官网', '丰茂烤串电话', '丰茂烤串冬天店内经营视频', '丰茂烤串加盟费多少']
hanlinkaorou	['韩林烤肉', '翰林烤肉']
@JingTie-Hotel	['精铁厚釜和精钢厚釜', '精铁厚釜是什么材料', '京铁鸿达实业有限公司']
tangquanliangzi	['汤泉良子', '汤泉良子价目表', '汤泉良子怎么样', '汤泉良子加盟', '汤泉良子方庄店', '汤泉良子有哪些项目', '汤泉良子有小保健不', '汤泉良子几点开门', '汤泉良子生意好吗', '汤泉良子上地旗舰店']
JingtieHotel	['精铁厚釜和精钢厚釜', '精铁厚釜是什么材料', '京铁鸿达实业有限公司']
zhangqiuhaitai	['章丘海鲜鱼市', '章丘海尔售后服务电话', '章丘海信泮山', '章丘海乐优自助餐价格', '章丘海底捞', '章丘海洋极地世界', '章丘海贝乐园', '章丘海拔最高的山', '章丘海悦宴酒店预订', '章丘海鲜市场哪个新鲜']
yunhuisuo	['云慧', '云麾将军', '云汇天地', '云晖资本', '云徽子', '云辉学院', '晕晖打一成语', '云回楚陌', '云麾勋章', '运回和不运回什么意思']
fengmaokaochuan	['丰茂烤串', '丰茂烤串加盟', '丰茂烤串官网', '丰茂烤串加盟费多少钱', '丰茂烤串全国分店地址', '丰茂烤串总店', '丰茂烤串加盟官网', '丰茂烤串电话', '丰茂烤串冬天店内经营视频', '丰茂烤串繁荣路店']
bulaoxilaocaiguan	['不老溪老菜馆(荣丰店)怎么样', '不老溪老菜馆怎么样']
podinns	['坡地', 'podium', 'podiatrist', '破地狱', 'podiatry', 'podium是什么意思中文', '破冰行动', '魄帝武神', 'position', 'podio']
CHAOZHOUHUI	['潮州', '潮州天气', '潮州市', '潮州天气预报', '潮州人', '潮州菜', '潮州话', '潮州美食', '潮州帮', '潮州景点']
NOVOTEL	['novotel', 'novo是什么牌子', 'novo口红', 'nova5', 'nova4', 'novo眼影', 'novo按钮', 'novo唇釉', 'novo怎么读', 'novosibirsk']
siyeniula	['四爷你被套路', '撕夜聂小雨', '四爷牛拉总店在哪', '四爷牛拉创始人', '四爷年妃', '肆野宁洛云', '四爷您又被套路了', '四爷牛拉 董事长', '思也念卿', '四爷牛拉']
hehuatai	['荷花', '荷花烟', '荷花图片', '合欢花', '荷花头像', '荷花简笔画', '荷花酒', '合欢', '荷花诗句', '合欢树']
jiangtaiwuer	['将太无二北京店', '将太无二菜单价目表', '将太无二什么档次', '姜太翁钓鱼愿者上钩钓的是谁', '将太无二', '姜泰伍', '将太无二什么意思', '将台湾割让给日本的条约', '将太无二是自助吗', '将太无二菜单']
戈拿旺巴西烤肉	['戈拿旺巴西烤肉自助餐', '戈拿旺巴西烤肉菜市口店', '戈拿旺巴西烤肉团购', '戈拿旺巴西烤肉表演', '戈拿旺巴西烤肉小营店', '戈拿旺巴西烤肉价钱', '戈拿旺巴西烤肉亚运村']
Guangming-Daily	['光明大陆', '光明大陆官网', '光明大陆哪个职业好', '光明大白兔牛奶', '光明大陆手游', '光明大陆手游下载', '光明岛十王', '光明岛小说', '光明大陆新区开服表', '光明大陆平民职业选择']
hankoujietou	['汉口解放公园', '汉口解放大道是哪个区', '汉口街头', '汉口街四斤烤肉', '汉口解放大道270号', '汉口街头 太阳宫', '汉口解放大道同济医院', '汉口街洗浴 ktv', '汉口解放大道三把刀', '汉口解放公园坐什么车']
wfjsd-wifi	['无法接受的我们不一样', '无法解释的文物', '无法解释的物理现象', '王府井书店网上购书', '王府井书店文具', '违法建设的危害性', '违法驾驶的危害怎么写']
DingJunHui	['丁俊', '丁俊晖', '定军山', '丁俊晖最新比赛消息', '丁俊晖2019最新比赛', '定君生', '定军山之战', '丁俊晖2019最新排名', '丁军']
zkungfu	['zkun.me']
tiancifuyuan1	['天赐福缘', '天赐福缘是什么意思', '天赐福院酒店怎么样', '天赐福院四合院酒店']
hankunlaw	['韩坤', '汉坤', '汉坤律师事务所', '汉坤实业', '韩坤个人资料', '汉坤鱼竿', '汉坤实业有限公司', '汉琨中医院', '含困的成语']
mingshiguang	['明石国行', '茗视光眼科医院', '明石国行公式', '茗视光', '铭是古代刻在器物上用来', '名士故事二则翻译', '名士故事二则', '明是故乡明的前一句', '名士故事二则阅读答案', '茗视光眼科医院好不好']
yunhaiyao	['云海仙踪', '晕海', '云海翻腾孙悟空', '云海肴', '云海牧鲲', '云海金属', '云海山庄', '云海玉弓缘', '云海中的风', '云海']
huachengshishang	['花城是谁', '花城是什么城市的名称', '画城市是视频的', '花城是什么级别的鬼', '花城是什么动漫里的', '华诚食尚酒店地址', '花城时尚酒店', '华诚是什么意思', '华程时尚酒店的地图', '花城是什么电视里的']
99inn.cc	['99inn.cc', '99inn无线网登录']
BlueNoteBJ	['blue note 北京']
rongchengguli	['荣成公交app下载', '荣成公交', '荣成赶海的地方', '荣成高铁时刻表', '荣程钢铁集团', '荣成公交车时间表', '荣成公交车路线时间表', '荣成赶海潮汐表', '荣成赶海', '荣成高铁站']
便宜坊哈德门店	['便宜坊哈德门店电话', '便宜坊哈德门', '便宜坊哈德门怎么样', '便宜坊哈德门店地铁', '便宜坊哈德门地址']
beautyfarm	['beauty翻译', 'beautiful', 'beauty翻译中文', 'beauty副词', 'beauty副词形容词形式', 'beauty服装是什么牌子', 'beauty粉底液排行榜', 'beauty防晒霜排名', 'beauty发音']
FamilyMart	['family名词的复数形式', 'family每个单词的意思', 'family漫画', 'family名词', 'family摩托车']
BlueNote	['blueness', 'bluenun红酒', 'blue note 北京', 'blue nile官网中文', 'bluenrg', 'blue牛排', 'blue nile钻戒', 'blue nile美国官网', 'blue女装']
wendingfu	['问鼎', '问鼎中原', '稳定器', '稳定', '问鼎巅峰', '文定', '稳定剂', '稳定性', '问鼎江湖']
fenglianbinguan	['烽联宾馆', '风恋冰心', '风恋冰心~凝露玫瑰~爱的赌约']
HuoLuHuo	['火炉火', '霍乱弧菌', '霍乱江湖', '活络', '活络油', '货轮', '霍乱', '火炉城市', '霍乱时期的爱情', '火炉']
BlueNote-5G	['blue note 北京', 'blue note jazz club', 'blue note 上海', 'blue note 北京官网', 'blue notes香水', 'blue note jazz 北京', 'blue notes香水多少钱', 'blue note 上海地址', 'blue note是什么意思', 'blue notes 爵士']
99inn.cn	['99inn.cc', '99inn无线网登录']
dadongkyd	['大东', '大董', '大东海', '大东南', '大动脉炎', '大动脉', '大动干戈', '大东女鞋', '大动脉在哪', '大东区']
tiancifuyuan3	['天赐福缘', '天赐福缘是什么意思', '天赐福院酒店怎么样', '天赐福院四合院酒店']
tangchaoktv	['唐朝', '唐朝皇帝', '唐朝历代皇帝', '汤潮', '唐朝历史', '唐朝好男人', '唐朝地图', '唐朝首都', '唐朝豪放女', '唐朝距离现在多少年']
zizhuyezonghui2	['紫竹夜总会是干嘛的', '紫竹夜总会洗脸', '紫竹夜总会消费水平', '紫竹夜总会是几百', '紫竹夜总会 北京', '紫竹夜总会 领班', '紫竹夜总会好玩吗']
zizhuyezonghui8	['紫竹夜总会是干嘛的', '紫竹夜总会洗脸', '紫竹夜总会消费水平', '紫竹夜总会是几百', '紫竹夜总会 北京', '紫竹夜总会 领班', '紫竹夜总会好玩吗']
北京市党派团体办公楼	['北京市党派团体办公楼', '北京市党派团体办公楼服务管理中心']
MeiNianDaJianKang	['美年大健康体检可信吗', '美年大健康', '美年大健康体检中心报告查询app', '美年大健康招聘', '美年大健康体检中心', '美年大健康体检中心官网查看报告', '美年大健康体检中心电话', '美年大健康体检中心怎么样', '美年大健康体检套餐', '美年大健康体检中心客服电话']
juelvbang	['倔驴帮', '倔驴表情包', '绝缕不如组成语']
lashangyin	['拉伤', '拉伤怎么办', '拉伤肌肉怎样好得快', '拉伤筋的症状', '辣上瘾', '拉伤筋怎么快速恢复', '辣尚宫', '拉伤多久才能恢复', '腊山国家森林公园', '辣上瘾代理']
nongtangli	['脓痰', '弄堂', '浓汤宝', '浓汤', '浓痰是怎样形成的', '弄堂小笼包', '弄堂记忆', '浓汤宝对身体有害吗', '浓痰是风寒还是风热', '浓痰带血']
Tai_Shu_Xi	['泰叔赶海', '泰顺天气', '泰顺天气预报', '泰叔赶海视频', '泰叔赶海百家号', '泰舒达', '泰顺', '泰舒达说明书', '太熟悉家常菜', '泰叔']
yunledi	['云联惠', '云龙', '陨落', '晕轮效应', '云龙湖', '韵律', '云亮', '云南', '云里雾里', '云岭先锋']
shuimumicheng	['水木迷城密室逃脱攻略']
Sizzler	['sizzle', 'sizzler', 'sizzler餐厅', 'sizzix', 'sizzler什么意思啊', 'sizzl', 'sizzurp', 'sizzler是什么菜', 'sizzle it your way', 'sizzler时时乐西餐厅']
hualala-wifi	['哗啦啦外卖怎么关联', '哗啦啦微信公众号', '哗啦啦外卖自提', '哗啦啦舞蹈', '哗啦啦微信', '哗啦啦外卖管理平台', '哗啦啦微信自助点餐', '哗啦啦网页版', '画啦啦网课怎么样', '哗啦啦微信点餐系统']
xizhimenbinguan	['西直门宾馆', '西直门宾馆电话', '西直门宾馆不对外营业', '西直门宾馆地址', '西直门宾馆预定', '西直门宾馆套间价格', '西直门宾馆官方网站', '西直门宾馆附近地铁站', '西直门宾馆 游泳', '西直门宾馆多少钱']
ROUCHUANWANGZONGDIAN	['肉串汪总店怎么样']
tangchaoKTV	['唐朝', '唐朝皇帝', '唐朝历代皇帝', '汤潮', '唐朝历史', '唐朝好男人', '唐朝地图', '唐朝首都', '唐朝豪放女', '唐朝距离现在多少年']
聚点串吧=交大店	['聚点串吧官网', '聚点串吧老板', '聚点串吧张霖简介', '聚点串吧投诉电话', '聚点串吧会员生日半价', '聚点串吧通州店', '聚点串吧 优惠券', '聚点串吧创始人电话', '聚点串吧餐饮公司', '聚点串吧公益西桥']
tpyzq-vip	['太平洋证券', '太平洋证券股票', '太平洋证券2019年中报', '太平洋蒸汽发生器', '太平洋证券大股东', '太平洋证券手续费多少', '太平洋证券是什么等级', '太平洋证券开通创业板', '太平洋证券泰安营业部', '太平洋证券左雪照片']
BJSFRBG	['北京师范大学', '北京师范大学珠海分校', '北京师范大学珠海分校教务管理系统', '北京师范大学研究生院', '北京师范大学法学院', '北京师范大学图书馆', '北京师范大学香港浸会联合国际学院', '北京师范大学本科招生网', '笔架山风景区', '北京市丰台区天气']
wedome-wifi	['wedome味是什么品牌']
gymboree	['gymbo主题曲', 'gymbo系统登录', 'gymbo什么意思', 'gymbo主题曲歌词', 'gymboree', 'gymbo主题曲中文', '金宝贝主题曲gymbo', 'gymbo歌词', 'gymbo英语怎么读']
bianjinggongheguo	['边境共和国(新奥店)', '边境共和国 大众点评', '边境共和国餐厅菜单', '边境共和国(荟聚购物中心)']
HuXiaoShanZhuang~1F	['呼啸山庄', '呼啸山庄简介', '呼啸山庄采用什么叙述方法', '呼啸山庄读后感', '呼啸山庄人物', '呼啸山庄电影', '呼啸山庄经典语录', '呼啸山庄人物关系图', '呼啸山庄好词好句', '呼啸山庄人物分析']
jindingxuan_5g	['金鼎轩', '金鼎轩菜单', '金鼎轩二公子大凡', '金鼎轩二公子', '金鼎轩地坛店', '金鼎轩菜单及价格', '金鼎轩雍和宫店地址', '金鼎轩24小时营业', '金鼎轩团结湖店', '金鼎轩方庄店电话']
tingyun	['婷婷', 'sting', '听书', '听说', '听雪楼', '停电', '停止编号', '听海', '听风者', '听妈妈的话']
meishenxuqing5G	['美神煦氰医疗美容', '美神煦氰', '美神煦氰美啦门诊', '美神煦氰整形', '美神煦氰美啦门诊地址', '美神煦氰美啦门诊骗', '美神煦氰生物胶粘合', '美神煦氰結婚了嗎', '美神煦氰双眼皮价格']
yuxueyuan	['育学园', '余学友', '育学园诊所', '俞学友', '与雪有关的诗句', '育学园app下载', '雨靴英语', '寓学于乐', '寓学于乐的意思是什么', '浴血羊山电影']
huashangjiudian	['华商酒店', '华商酒店管理有限公司', '华商酒店招聘信息', '华商酒店 自助餐', '华商酒店(厦门湾店)怎么样', '华商酒店-中餐厅怎么样', '华商酒店电话漳州', '华商酒店(淦河大道)怎么样', '华商酒店-KTV怎么样']
HUAZHU-OrangeHotel	['huazhuorangehotel']
wujiekongjian-SYQ	['無界空间招聘什么岗位']
CUPONE-2	['coupon的汉语意思', 'cupone', 'coupon rate', 'coupon怎么读音', 'coupon的意思', 'coupon 翻译', 'coupon是什么意思中文翻译', 'cupon是什么意思', '醋泼尼龙松副作用', 'coupons怎么读音发音']
Orange-Hotel	['orange后面加es还是s']
bjfyxybg	['北京法院信息网审判', '兵甲富于胸中', '北京飞跃鞋实体店地址', '北京风雅小筑日本料理', '北京阜阳心血管病医院', '搬家非要选日子吗', '北京凤仪轩', '宝鸡方言闲转记歌词', '北京法院悬赏公告', '北京府右小学在哪里']
beifangyouyicun	['北方有隐翅虫吗', '北方有萤火虫吗', '北方有一鱼名为鲲', '北方有一点点奶茶吗', '北方有一个海南', '北方有伊人在水一方', '北方有一佳人 诗', '北方有一口井封印', '北方又一村电话', '北方又一村怎么样']
suzumei	['suzuki', '宿醉', 'suzuki摩托车', '诉组词', '俗组词', '宿醉2', '赎罪', '宿醉3', 'suzuki是什么牌子', 'suzumu']
suning-free	['肃宁房价2019最新房价', '苏宁返利平台叫什么', '肃宁房价', '苏宁服务电话', '苏宁分期付款流程', '苏宁分期', '苏宁返利', '苏宁分期付款买手机', '苏宁服务市场', '肃宁房屋出售最新信息']
CUPONE-1	['coupon的汉语意思', 'cupone', 'coupon rate', 'coupon怎么读音', 'coupon的意思', 'coupon 翻译', 'coupon是什么意思中文翻译', 'cupon是什么意思', '醋泼尼龙松副作用', 'coupons怎么读音发音']
hmvkafe	['海马v70空调格在哪里']
dizhibinguan	['低脂饼干有哪些', '低脂饼干', '低脂冰淇淋', '帝之冰魂资源', '低脂饼干的做法', '地质宾馆', '帝智冰箱怎么使用开关', '低脂饼干热量', '低致病性禽流感的治疗', '地质宾馆电话']
HUAZHU_Ibis	['花坠成语', '花锥', '滑椎', '花追肥用什么肥料', '滑坠钓法', '滑坠', '花缀的意思是什么', '花追叶棍型研究', '花追寻凋零']
helijia-bj	['河狸家', '河狸家官网', '河狸家美甲师真实收入', '河狸家客服电话', '河狸家怎么样', '河狸家客服', '赫里将军', '河狸家新手能接到单吗', '河狸家的现状', '合理减肥法']
wanglibank	['网利宝', '王力宏', '网利宝最新消息', '王立波', '王立彬', '王林', '王琳凯', '王琳', '王丽波', '网利宝交流群']
meishenxuqing	['美神煦氰医疗美容', '美神煦氰', '美神煦氰美啦门诊', '美神煦氰整形']
xibeihanzi	['西北航空', '西北航空大学', '西贝海鲜', '西北汉子', '西北汉子的性格特点', '西北航天航空大学', '西北航空公司', '西北行攻略', '西贝海鲜汇', '西贝海鲜汇槐安路店']
helijia	['合力', 'helicopter', '何立峰', '赫莲娜', '鹤立鸡群', 'helio', 'helios', 'helium', '合力泰', '河流']
huajiayiyuan	['花家怡园四合院', '花家怡园四季青店', '花家怡园', '花家怡园金融街店', '花家怡园融科店', '花家怡园菜单', '花家怡园清华西路店', '花家怡园圆明园店', '花家怡园惠新店', '花家怡园东直门店']
Homeinns	['homeinn', 'homie', 'homeie是什么意思', 'homeinn什么意思', '红霉素', 'homeis', 'homein', 'homeic', 'homeins', '红玫瑰']
wennuandelvtu	['温暖的旅程作文600字', '温暖的旅程', '温暖的李免费漫画', '温暖的李', '温暖的旅程作文500字', '温暖的旅程800字', '温暖的旅程作文800字', '温暖的李漫画百度网盘', '温暖的旅行600字作文', '温暖的离别']
lanhuhui	['蓝湖', '兰花', '兰花草', '兰花指', '蓝狐', '兰花蟹', '蓝环章鱼', '蓝灰色', '蓝琥珀柯北辰', '蓝胡子']
wanglaoliu	['王老吉', '王老菊', '王老板', '王老五', '王老师', '王老吉吉悠', '王老六', '王老吉和加多宝是怎么回事', '王老虎抢亲', '王老七']
shikongtang	['时空偷渡少女', '时空特战队', '是空调费电还是风扇费电', '时空特警满座衣冠胜雪', '时空偷渡之洪荒 小说', '时空头号玩家', '时空特警', '时空泰运回馈', '时空偷猎者txt下载']
salahuaer	['撒拉花儿西域美食', '撒拉花儿', '撒拉花儿是什么意思', '萨拉花西坝河店', '撒拉话翻译', '萨拉花饭店', '撒拉花是什么意思', '撒拉话是什么话', '撒拉花儿太阳宫电话']
beiwaiqingshao	['北外青少', '北外青少英语', '北外青少英语校区', '北外青少英语校区电话', '北外青少校区', '北外青少官网', '北外青少英语培训中心怎么样', '北外青少英语app安卓', '北外青少英语官网平台', '北外青少英语费用']
SunnyDental	['sunny的男朋友']
muwushaokao	['木屋烧烤', '木屋烧烤店', '木屋烧烤几点海鲜半价', '木屋烧烤官网', '木屋烧烤菜单', '木屋烧烤营业时间', '木屋烧烤老板', '木屋烧烤加盟费多少', '木屋烧烤创始人']
4008190099	['4008190909', '4008190988', '4008190770443', '4008190488', '4008190186', '4008190518', '4008190099']
menggongfang	['梦工坊', '梦工坊咖啡吧', '梦工坊影城', '梦工坊app', '勐拱翡翠官网', '梦工坊咖啡', '勐拱翡翠', '梦工坊影城蔡塘', '梦工坊青年', '梦工坊技术']
saboten	['萨博', 'sabotage', '萨博尼斯', 'sabon', '萨博汽车', 'saboteur', 'sabor', '萨博班', '萨博95']
Pandabrew	['盼达不退押金', '盼达不退押金怎么处理', 'pandas', 'panda包', 'panda包包官网', '盼达北碚网点', '盼达爆胎', '潘达蹦床主题公园门票', '盼达不退钱咋办', 'panda冰箱怎么样']
OrangeHotel	['orange后面加es还是s']
qiaobamei	['乔巴', '乔宝儿君之牧免费阅读', '乔巴图片', '乔巴山', '侨胞', '翘班', '乔巴头像', '乔宝宝', '乔巴加点', '乔帮主']
黑土印象大厅1	['黑土印象凯旋城店', '黑土印象三元桥店', '黑土印象三元桥', '黑土印象亚运村店电话', '黑土印象(亚运村店)怎么样', '黑土印象(万科红店)怎么样', '黑土印象风味餐厅怎么样', '黑土印象(三元桥店)', '黑土印象亚运村店关闭']
shenmimei	['恐怖复苏', '神秘客', '神秘老公惹不起', '神秘海域', '神秘博士', '神秘老公有点坏', '神秘果', '神秘巨星', '神秘爹地惹不起', '神秘岛']
chanzuimao	['馋嘴', '馋嘴牛蛙', '馋嘴蛙', '馋嘴叶', '馋嘴王小闹', '馋嘴猫', '馋嘴鸭', '馋嘴公主', '馋嘴鱼', '馋嘴饼']
@糊涂妹刀削面	['糊涂妹asmr']
lanzhoulamian	['兰州拉面', '兰州拉面热量', '兰州拉面的做法', '兰州拉面菜单', '兰州拉面是哪个民族', '兰州拉面图片', '兰州拉面汤料配方单', '兰州拉面粗细', '兰州拉面是哪里的', '兰州拉面排行榜']
yuzhiguang	['欲之国太子在线读', '预制管桩', '预制管桩验收规范标准', '欲之寡欢白度云', '玉之光', '玉之光整形美容', '雨之国', '御之谷网络科技', '预制过梁']
wangsteak	['王朔', 'wangs调味品品牌']
nanmensijishuanrou	['南门四季涮肉', '南门四季涮肉怎么样', '南门四季涮肉左家庄店', '南门四季涮肉(亚运村店)', '南门四季涮肉(芍药居北里店)怎么样', '南门四季涮肉(五棵松店)怎么样', '南门四季涮肉 立水桥', '南门四季涮肉五棵松店', '南门四季涮肉东坝店']
chuanshifengge	['川师分数线', '串式风筝', '串式风筝图片大全', '传世风景二手房出售', '传世封号王爵升级表', '穿石风图片', '串式风筝简笔画幼儿', '串式风车怎么安装图解', '传世风宝', '传世风景幼儿园怎么样']
HUAZHU-Hanting.	['华住汉庭酒店wifi密码', '华住汉庭', '华住汉庭酒店', '华住汉庭官网', '华住汉庭宁波', '华住汉庭酒店数据泄漏', '华住汉庭wifi密码认证', '华住汉庭wifi密码', '华住汉庭索菲亚', '华住汉庭的密码是什么']
hongxizu	['红袖添香', '洪秀全', '洪秀柱', '红星照耀中国', '红星美凯龙', '洪学智', '红星闪耀评价', '红细胞', '红袖', '虹吸']
tuojiangxiaozhen	['沱江小镇', '沱江小镇对外经贸大学', '沱江小镇(安贞店)', '沱江小镇餐饮管理有限公司', '沱江小镇(安贞店)商户概况', '沱江小镇对外经贸']
BUU-LIB	['buuf加成是什么意思', 'buudien', 'buubei', 'buus', 'buuf换装是什么意思', 'buud', 'buupnn', 'buudien在哪']
sinopec	['sinopec', 'sinoc', 'sinopec是什么意思', '希努尔', 'sinobi', 'sinomax', 'sinofsx', 'sinobi手表是什么牌子', 'sinoc币', 'sinology']
伊藤洋华堂亚运村店	['伊藤洋华堂亚运村店', '伊藤洋华堂亚洲旗舰店', '伊藤洋华堂亚运村营业时间', '伊藤洋华堂亚洲新概念店', '伊藤洋华堂亚洲旗舰店招聘信息', '伊藤洋华堂亚洲第一', '伊藤洋华堂亚瑟士', '伊藤洋华堂亚洲 开业', '伊藤洋华堂亚运村店退换货', '伊藤洋华堂亚洲旗舰店2018年呈现']
bengeshousi	['本格寿司', '本格寿司 杭州', '本格寿司 北京']
bibichi	['哔哔', 'bibibi 官网', '哔哔哩哩', 'bibibi 哔哩哔哩下载', '比比皆是', 'bibi直播', '比比东', 'biubiu加速器', '笔笔攒是什么意思', '比比奇']
@茶花妹子过桥米线	['茶花妹子过桥米线', '茶花妹子过桥米线怎么样', '茶花妹子过桥米线地安门1店怎么样', '茶花妹子过桥米线(地安门1店)怎么样', '茶花妹子过桥米线 北京']
五指生亚运村店	['五指生亚运村店', '五指生亚运村店电话', '五指生亚运村店图片', '五指生亚运村足疗', '五指生亚健康保健中心怎么样', '五指生亚运村营业时间']
dechuanjia	['德川', '德川家康', '德川家', '德川幕府', '德川家光', '德川家族', '德川庆喜', '德川纲吉', '德川茂茂', '德川光国']
diguashequ	['地瓜烧', '地瓜社区', '地瓜是什么', '地瓜生芽还能吃吗', '地瓜什么时候成熟', '地瓜是凉性还是热性', '地瓜是发物吗', '地瓜烧白酒', '地瓜烧酒', '地瓜是不是红薯']
交通银行信用卡	['交通银行信用卡电话', '交通银行电话', '交通银行etc', '交通银行客服', '交通银行客服电话', '交通银行app', '交通银行董事长', '交通银行网点', '交通银行官网', '交通银行招聘']
shigehuntun	['十个馄饨差不多多少克', '十个馄饨的热量', '十个混沌多少克', '十个荤菜', '十个混沌多少热量', '十个婚礼一个葬礼', '是个混油皮的粉底液', '十个婚姻九个不幸福', '是个婚礼现场唱的歌']
mengjizhoupu	['孟季仲', '孟记粥铺', '孟集中心卫生院', '孟季仲伯', '蒙几种读音组词', '孟集中心校概况']
Huizuoshenjitang	['huizuoshenjitang']
YummyBox1	['yummy比较级和最高级', 'yummy表情包']
zhangliangmalatang	['张亮麻辣烫', '张亮麻辣烫是谁开的', '张亮麻辣烫加盟费用', '张亮麻辣烫加盟', '张亮麻辣烫加盟费用需要多少钱', '张亮麻辣烫创始人和杨国福', '张亮麻辣烫官网', '张亮麻辣烫老板叫什么', '张亮麻辣烫百度百科', '张亮麻辣烫什么梗']
ContainerBeerShop	['containerbeershow']
zixiamen	['紫霞', '子痫', '自相矛盾', '子夏', '紫霞仙子和至尊宝', '紫霞仙子图片', '紫霞神功', '紫霞湖', '子痫前期', '自限性疾病']
金草帽炭火烤肉店	['金草帽炭火烤肉', '金草帽炭火烤肉(东五条路附近)怎么样', '金草帽炭火烤肉怎么样']
坦坦大炉望京店1	['坦坦大炉望京店', '坦坦大炉望京店怎么走', '坦坦大炉望京店 团购', '坦坦大炉望京店价格', '坦坦大炉望京烤肉店', '坦坦大炉望京店坐什么车']
cafebene	['cafebar', 'cafe杯子', '崔傲菲儿百度百科']
zhangshifu	['张少华', '张绍刚', '樟树', '张帅', '张顺', '张双利', '张圣群', '掌上明珠', '掌上东航', '章士钊']
MINGTAIYU1	['明台', '明太鱼', '明太子', '明太祖', '明太鱼干的做法大全', '铭泰', '明泰铝业', '明泰', '明太鱼是什么鱼', '明台的父亲']
裕食坊私家湘菜	['裕食坊私家湘菜怎么样']
MAZHA-JIUWU	['蚂蚱几条腿', '蚂蚱简笔画', '马扎价格', '蚂蚱酱', '蚂蚱叫声播放', '蚂蚱酱的做法', '蚂蚱叫声', '蚂蚱鸡', '蚂蚱几条腿打一数字', '蚂蚱加工怎样排便']
huohuozhuti	['火火中国火火时代广场舞', '火火中国梦广场舞', '火火中国风', '火火中国风广场舞茉莉', '火火中国风春英广场舞', '霍霍粥怎么做', '火火中国梦', '火火中取栗的意思', '火火中国情主持词', '霍霍正气水能洗澡吗']
TOMNTOMSCOFFEE1	['tomntomscoffee中文叫什么', 'tomntomscoffee(龙湖时代天街店)怎么样']
lazhuang	['蜡烛', '蜡烛图片', '拉珠', '蜡烛图', '蜡烛英语', '蜡烛拼音', '蜡烛人', '蜡烛包', '蜡烛简笔画', '辣庄']
Tianfujiachangcai	['天辅家长学院张莉琳', '天府家常饭店怎么样', '天辅家长学院有用吗', '天福家常菜餐馆怎么样', '天福家常菜馆(芙蓉巷店)怎么样', '天府加昌曲天姚擎羊', '天福家常菜馆怎么样', '天福家常菜馆粥·水饺城怎么样']
warawara	['warawa']
CupOne_5G	['cupone什么意思']
JinYongKTV	['金庸', '金庸小说', '金庸网', '金庸作品', '金庸群侠传', '金庸群侠传x', '金庸群侠传x攻略', '金庸武侠', '金泳勋', '金庸小说顺序']
熔时FIRESIDE	['熔时fireside评价', '熔时fireside官網', '熔时fireside连锁', '熔时fireside老板是谁', '熔时fireside加盟', '熔时fireside老板']
MINGTAIYU2	['明台', '明太鱼', '明太子', '明太祖', '明太鱼干的做法大全', '铭泰', '明泰铝业', '明泰', '明太鱼是什么鱼', '明台的父亲']
TanTanDaLu	['坦坦荡荡', '坦坦大炉', '坦坦荡荡什么意思', '探探对方账号异常 不能回复消息', '谈谈对环境保护的认识', '谈谈对环境保护的认识 普通话', '坦坦荡荡做人,踏踏实实做事', '探探电话客服', '坦坦荡荡做人的句子', '探探的真实头像认证别人看得到吗']
四季民福wifi	['四季民福网上预约', '四季民福望京', '四季民福wifi密码', '四季民福王府井店预约', '四季民福武汉有吗', '四季民福王府井烤鸭店', '四季民福为什么那么火', '四季民福外卖', '四季民福旺角店电话', '四季民福望京哪家店好']
Wanrongxiaochu	['万荣笑话', '万荣笑话段子', '万荣小学', '万荣小三鼓队运城表演', '万荣小镇', '万荣小区租房', '万荣笑话七十二则', '万荣小区 物业', '万荣小区二手房价', '万榕小厨']
yiruntang	['亿润投资', '伊润藤二惊选集富江', '颐润堂望京店', '亿润投资可靠吗', '伊润藤二惊选集双一', '益润堂怎么样', '颐润堂五道口', '亿润投资集团有限公司', '颐润堂王府井', '屹润投资有限公司']
剪艺人生－中福	['剪艺人生望京中福店', '剪艺人生望京', '剪艺人生华彩店电话', '剪艺人生理发店怎么样', '剪艺人生怎么样', '剪艺人生望京夏都店', '剪艺人生西门子', '剪艺人生将台路店', '剪艺人生现在什么价位', '剪艺人生 价格']
kuaikan_soho	['快看视频', '快看视频app苹果', '快看上特别污的漫画', '快看视频app官网', '快看上什么腐漫好看', '快看世界', '快看世界北京科技有限公司', '快看视界激活码', '快看视频.m3u8', '快看商城']
huangtucheng	['黄土成语', '黄土尘埃已消遁猜一肖', '皇土成语', '黄土成分', '黄土城', '黄土沉香多少钱一克', '黄土城站', '黄土尘埃已消遁什生肖', '黄土朝天', '黄土城到延庆']
hongjingyu	['洪金宝', '红景天', '红警', '红景天口服液', '洪金宝电影', '红景天的功效与作用', '红警3', '红金龙', '洪金权', '红景天价格']
HanTing	['寒天', '韩童生', '韩天宇', '汉庭', '汉庭酒店', '汉天子', '旱獭', '憨态可掬', '寒天帝', 'hanteo']
yixuanjiaozi	['奕炫价格', '一轩饺子馆', '艺轩教育', '忆璇教你蹦迪全第一集', '一轩饺子馆 望京', '伊萱佳人化妆品怎么样', '艺轩家具', '忆璇教你蹦迪二十六', '易萱减肥', '忆璇教你蹦迪一']
BARSAK1	['bars是什么意思', 'bars疗愈骗局', 'barsh', 'bar是什么意思', 'bars疗愈', 'barstow', 'barsh手表', 'barstool', 'bar是什么单位', 'bershka']
Baihualin	['白话', '白化病', '白桦林', '白桦树', '白皇后', '百花奖', '白话文', '百花奖张译输给李易峰', '百花山', '百花']
qihuannuanwu	['奇幻暖暖公主图片', '奇幻暖暖图片大全']
luckincoffee-Guest	['luckincoffee-guest', 'luckincoffee广州门店', 'luckincoffee果汁口味', 'luckincoffee广告百度云', 'luckincoffee广告视频', 'luckincoffee广告费多少', 'luckincoffee关门了', 'luckincoffee光谷创业街位置']
火齐潮汕砂锅粥	['火齐潮汕粥', '火齐潮汕砂锅粥菜单', '火齐潮汕砂锅粥怎么样', '火齐潮汕砂锅粥(国贸店)怎么样', '火齐潮汕砂锅粥(木樨园店)怎么样', '火齐潮汕砂锅粥(合生汇店)怎么样', '火齐潮汕砂锅粥价目表', '火齐潮汕砂锅粥(太阳宫凯德店)怎么样', '火齐潮汕砂锅粥加盟费', '火齐潮汕砂锅粥(慈云寺店)怎么样']
sijiminfu	['四季民福', '四季民福烤鸭店', '四季民福烤鸭', '四季民福故宫店', '四季民福烤鸭店预约', '四季名店', '四季民福烤鸭店必点菜', '四季民福菜单价格表', '四集迷你剧千里送子', '四季明福烤鸭店怎么样']
xiaoshiguangmang	['小时光免费观看', '小时光灭绝', '消逝光芒', '小时光免费阅读', '小时光面馆', '小时光免费', '消逝光芒最后剧情', '小时光面膜', '小时光免费网站']
bibigo_soho	['bibigo是要撤出中国吗']
duolezhiri	['多乐之日', '多乐之日官网', '多乐之日蛋糕', '多乐中国象棋下载', '多乐中国象棋', '多乐之日加盟费多少钱', '多乐中国象棋手机版', '多乐中国象棋官方下载', '多乐之日蛋糕订购', '多乐之日蛋糕价格表']
剪艺人生-夏都	['剪艺人生望京中福店', '剪艺人生望京', '剪艺人生华彩店电话', '剪艺人生理发店怎么样', '剪艺人生怎么样', '剪艺人生望京夏都店', '剪艺人生西门子', '剪艺人生将台路店', '剪艺人生现在什么价位', '剪艺人生 价格']
pangzilongxia5	['胖子龙虾', '胖子龙虾马家堡店', '胖子龙虾宋家庄店', '胖子龙虾石景山店', '胖子龙虾望京店', '胖子龙虾石景山店电话', '胖子龙虾七克拉店菜单', '胖子龙虾老板是谁', '胖子龙虾大屯路店', '胖子龙虾大屯店']
MrPIZZA	['mrpii', 'mrpizza', 'mr平扫', 'mrpizza是什么品牌', 'mrpizza官网', 'mrpizza和必胜客', 'mr平扫是什么检查', 'mrpii的基本思想和特点是什么', 'mr平扫是不是磁共振', 'mr披萨官网']
kangyunyangsheng	['康云养生堂', '康韵养生会馆正规吗', '康韵养生馆怎么样', '康韵养生会馆十里河', '康韵养生会馆 概况', '康韵养生会所怎么样', '康韵养生会馆 评论']
多乐之日望京SOHO店	['多乐之日望京soho哪个面包好吃']
LaTercera	['later创作的原声', 'later词根']
一个叫川的地方	['一个叫川的地方北京', '一个叫川的地方官网', '一个叫川的地方南昌', '一个叫川的地方谁开的']
huohuozhuti2	['火火猪', '火火烛烛的意思', '活活捉一只麻烦精']
zhuluchalou	['逐鹿茶楼学院路店', '逐鹿茶楼', '逐鹿茶楼西直门店', '逐鹿茶楼望京', '逐鹿茶楼知春路店', '猪碌肠', '逐鹿茶楼贵足会正规吗', '逐鹿茶楼明光桥店', '逐鹿茶楼路六道口', '猪碌肠是什么']
WARAWARA	['warawa']
