LunYuCunZhuang.	['lunyucunzhuang', 'lunyucunzhuang(tian鹅wandian)zenmeyang']
AppleStore	['apple storewufaxiazai', 'apple storewufalianjie', 'apple storezidongkoufei', 'apple storelipinka', 'apple storezenmegaichengzhongwen', 'apple storexiazai', 'apple storedabukai', 'apple storeweixiu', 'apple storetuikuanshenqing', 'apple storewufagengxin']
UYOUNG	['uyoung nianqingrenlvxing', 'uyoungyouyangyanwo', 'juyoung']
ChateauStarRiver	['chateaustarriver.com']
青年公社	['qingniangongshecanting', 'qingniangongshecantingwangsiying', 'suzhouqingniangongshe', 'suzhouqingniangongshe', 'qingniangongshecantinggongzhufen', 'qingniangongshewuyedianhuahaoma', 'qingniangongshesuzhouyuanqu', 'qingniangongshe liangxiangdian', 'suininglongtengqingniangongshe']
Bankcomm	['bankcomm.com']
TangGong	['tanggonghaixianfang', 'tanggongmeirentianxia', 'tanggongyuanzhu', 'tanggonghong', 'taohong', 'tanggongshinvtu', 'tanggongxiaoju', 'tanggong', 'tanggongmishi', 'tanggongyan']
蝎王府	['xiewangfei', 'xiewangfuhufangqiaodiandianhua', 'xiewangfuguanwang', 'xiewangfuxisanqidian', 'xiewangfuyangxiezidianzhi', 'xiewangfuyangxiezipanjiayuandian', 'xiewangfuyangxiezijiamengfeiduoshao', 'xiewangfuhuangcundian', 'xiewangfudianhua', 'xiewangfuyangxiezi']
chaoyangjianshen	['zhaoyangjianshen', 'zhaoyangjianshencao', 'zhaoyangjianshengjinglaoyuan', 'chaoyangjianshengsuliaochangzenmeyang', 'zhaoyangjianshenjiaolianzhaopinwang', 'zhaoyangjianshen(yangxidian)zenmeyang', 'zhaoyangjianshenjulebuzenmeyang', 'zhaoyangjianshenhuisuo(xingxiangdian)zenmeyang']
眉州东坡酒楼	['meizhoudongpojiuloudingcandianhua', 'meizhoudongpojiuloushijingshandian', 'meizhoudongpojiulouzenmeyang', 'meizhoudongpojiuloufanhaidian', 'meishanmeizhoudongpojiulou', 'meizhoudongpojiuloubeijing', 'meizhoudongpojiulouzhaopin', 'meizhoudongpojiuloudianhua', 'meizhoudongpojiuloulianridian', 'meizhoudongpojiuloucaidan']
jazz.ya	['jazzyajueshiwulaoban', 'jazzyaoxueduojiunengrumen']
AMBER	['ambershishenmeyisizhongwen', 'amberyingwenmingyuyi', 'amber alert', 'amber room', 'amberliuxianhua', 'amberyingwenming', 'amberzenmedu', 'amber label', 'ambergris']
rujia	['rujia', 'rujiaoqi', 'rujiao', 'rujiajiudian', 'rujia', 'rujiaozhen', 'rujiao', 'rujiaochuangdian', 'rujiadianhua', 'rujiaosiqi']
太平洋咖啡	['taipingyangkafeicaidan', 'taipingyangkafeiguanwang', 'taipingyangkafeijiamengfei', 'taipingyangkafeihaohema', 'taipingyangkafeimendian', 'taipingyangkafeituijian', 'taipingyangkafeicaihongmeimei', 'taipingyangkafeijiamengtiaojian', 'taipingyangkafeihexingbake', 'taipingyangkafeizenmeyang']
YFJAZZ	['yufengjing安zhongzhuchangdizhi']
CMCC-WEB	['cmccwebshishenmeyisi', 'cmccwebzenmebanli', 'cmccwebshishenmewangluo', 'cmccwebshoufeima', 'cmccwebmianfeizhanghaomima', 'cmccwebzenmemianfeilianjie', 'cmccwebdengluwangzhan', 'cmccwebdiannaolianjiebushang', 'cmccwebdenglujiemian', 'cmccwebzenmelianjie']
100inn	['100inndewifimima']
qianzilianzudao	['qianzilianzudao', 'qianzilianzudaoyoufeijima', 'qianzilianzudaozongbu', 'qianzilianzudao', 'qianzilianzudaoxiaofeijiage', 'qianzilianzudaokeyixiuxima', 'qianzilianzudaoshizhengguidema', 'qianzilianzudaojiamengtiaojian', 'qianzilianzudaoshishenzhenyouma', 'qianzilianzudao(jinniujiehetangyuesedian)zenmeyang']
HUAZHU-Hanting	['huazhuhantingjiudianshujuxielou', 'huazhuhanting', 'huazhuhantingshangwangdengludizhi', 'huazhuhantingningbo', 'huazhuhantingshizhi', 'huazhuhantingjiudian', 'huazhuhantingwifidengluyemian', 'huazhuhantingguanwang', 'huazhuhantingjiudianwifimima', 'huazhuhantingkefudianhua']
misshuo	['misshuoshi']
tianehui	['tian鹅hui', 'tian鹅huifeima', 'tian鹅huibuhuifei', 'tian鹅huiyouyongma', 'tian鹅huifeimatanengfeiduogao', 'tian鹅huihua', 'tian鹅huiben', 'tian鹅huishengkouqin', 'tian鹅huigongjirenma', 'tian鹅huiqianshuima']
HI辣火锅	['hilahuoguochuangshiren', 'hilahuoguonengjiamengma', 'hilahuoguodengjiajiaguanwang', 'hilahuoguozaineixiechengshi', 'hilahuoguodianjiameng', 'hilahuoguojiamubiao', 'hilahuoguodizhi', 'hilahuoguoxiamen', 'hilahuoguobeijingnaliyou', 'hilahuoguotongzhou']
24小时自助图书馆	['24xiaoshizizhutushuguanfeiyong', '24xiaoshizizhutushuguanzenmeshiyong', 'zhengzhou24xiaoshizizhutushuguan', 'tangshan24xiaoshizizhutushuguan', 'jinan24xiaoshizizhutushuguan', 'quzhou24xiaoshizizhutushuguan', 'yiwu24xiaoshizizhutushuguan', '24xiaoshizizhutushuguanshujiduoma', 'hefei24xiaoshizizhutushuguan', 'baoding24xiaoshizizhutushuguan']
BOC_FreeWLAN	['boc_freewlanmima']
CMCC	['cmccmianfeiwifi', 'cmccshishenmewangluo', 'cmccdewifimimashiduoshao', 'cmccmima', 'cmccshenmeyisi', 'cmcczhanghao', 'cmcczenmelianjie', 'cmccweb', 'cmccedu']
chongqingxiaomian	['chongqingxiaomian', 'chongqingxiaomiandezuofa', 'chongqingxiaomianjiamengdian', 'chongqingxiaomiandezuofajipeiliao', 'chongqingxiaomiantupian', 'chongqingxiaomianpeixunnajiazuihao', 'chongqingxiaomianjiamengyaoduoshaoqian', 'chongqingxiaomianzuoliaopeifang', 'chongqingxiaomian50qiangmingdan', 'chongqingxiaomiandejiandanzuofa']
jinshoushao	['jinshoushao', 'jinshoushaodongbeicai', 'jinshoushaojiamengxuyaoduoshaoqian', 'jinshoushaodianhua', 'jinshoushaocaidan', 'jinshoushaohaixiandaka', 'jinshoushaodongbeicaizhaopaicai', 'jinshoushaojiameng', 'jinshoushaofatoudiandianhua', 'jinshoushaohejinzhangshaoneigehao']
shishangmatou	['shishangmatou', 'shishangmatouquanguoliansuodian', 'shishangmatoumeirongmeifa', 'shishangmatoubeijingliansuodian', 'shishangmatouzongbudizhi', 'shishangmatoushangxueyuan', 'shishangmatoumeirongyuanzenmeyang', 'shishangmatouzongdiandianhua', 'shishangmatousongjiazhuangdianhua', 'shishangmatouqingnianludian']
ziroom	['ziroomziru', 'ziroommorenwifimima', 'ziroomziruneiwang', 'ziroomyouxiang', 'ziroomzirushenzhen', 'ziroomziruwuhan', 'ziroomdianhua', 'ziroomluyouqizenmedenglu', 'ziroomzirudenglu', 'ziroomguanwang']
ZTYY	['zuotingyouyuan', 'zhitongyaoyouneixie', 'zhutianyiye', 'zhitengyaoyounajizhong', 'zutieyouyongma', 'zhentouyingyu', 'zuotianyingyu', 'zoutianyayuanchang', 'zuotianyingyudanci', 'zhangtieyingyu']
@全羊肉泡馍	['quanyangroupaomo(qingnianluzongdian)zenmeyang', 'quanyangroupaomo(qingnianluzongdian)']
.@博成雅居酒楼	['bochengyajujiuloutuangoumeituan', 'bochengyajujiulou(qingnianludian)', 'bochengyajujiulou(chaowaidian)zenmeyang', 'bochengyajujiuloudingcan']
MOBE	['mobeshenmeyisi', 'mobee', 'mobei', 'mobei', 'money', 'mobeizhizhan', 'movement', 'mobel', 'mobeibingwang', 'move']
huaniucanguan	['huaniucanguan', 'huaniucanguan(guomeidian)zenmeyang', 'huaniucanguanzaibeijingyoujijiadian', 'huaniucanguan(guomeidian)', 'huaniucanguanshenmecaidan', 'huaniucanguanshilipudian', 'huaniucanguanshenmecaixi']
有一串吧	['youyichuanbadongbadiandianhua', 'youyichuanba(dongbadian)zenmeyang', 'youyichuanba(qingnianludian)zenmeyang', 'youyichuanba(jiangtailudian)zenmeyang']
WX-QJD	['wuxiqijiadianshangzhuangshigongsi', 'weixingqianjindingzenmeshiyong', 'wuxingqujiedaoguanxiaqutu', 'wuxianqiaojiedaobanshichu', 'wenxingqijideyiwenci', 'wuxianqianjiaodekeyiquxiaoma', 'wuxiquanjudekaoya', 'wuxianqujiandebiaoshifa', 'weixinqunjiaduoshaorenmanle', 'wuxianqiaojieduoyuan']
LianJia	['lianjiahangkong', 'lianjia', 'lianjia', 'lianjia', 'lianjiachangdou', 'lianjiang', 'lianjiawang', 'lianjia', 'lianjiadichan', 'lianjiang']
HEYTEA	['heyteafanyi', 'heyteashishenmeyisi', 'heyteazenmedu', 'heytealimingshijian', 'heyteaxichaguiyang', 'heyteaxichajiamengma', 'heyteaxichaguanfangjiameng', 'heyteaxicha guanwang', 'heyteaxichajiamengfeidagaiduoshao', 'heyteaheheektea']
Starbucks	['xingbake']
bianlifeng	['bianlifeng', 'bianlifengjiamengfeiduoshao', 'bianlifengguanwang', 'bianlifengwurenbianlidian', 'bianlifenggongzizenmenamegao', 'bianlifengzhaopin', 'bianlifengliansuobianlidian', 'bianlifengjiamengfei', 'bianlifengjiameng', 'bianlifengdianhua']
weishiguang	['weishiguang', 'weishiguangyunibukegufu', 'weishiguangduntaiyangmo', 'weishiguanggaonagenvdeshishui', 'weishiguanggao', 'weishiguangduntaiyangmo', 'weishiguangguanwang', 'weishiguangtuyiwang', 'weishiguangktv', 'weishiguangyumeishibukegufu']
Waipojia	['waipojia', 'waipojiacaidan', 'waipojiajiamengfeiduoshao', 'waipojiabidianzhaopaicai', 'waipojiaguanwang', 'waipojialaoban', 'waipojiashishenmecaixi', 'waipojiadepenghuwan', 'waipojiazongdian', 'waipojiayingwen']
西贝莜面村	['xibeiyoumiancunzenmedu', 'xibeiyoumiancunzenmenian', 'xibeiyoumiancuntupian', 'xibeiyoumiancunjiameng', 'xibeiyoumiancunjiamengfei', 'xibeiyoumiancunlaoban', 'xibeiyoumiancuncaidan', 'xibeiyoumiancunguanwang', 'xibeiyoumiancundianhua', 'xibeiyoumiancun12gebidiancai']
WAGAS	['wagasguanwang', 'wagasshishenmeyisi', 'wagasreliang', 'wagasnanjing', 'wagasshineigeguojiade', 'wagaskafei', 'wagashi', 'wagaszenmedu', 'wagasshala', 'wagascaidan']
sdt	['sidatianwang', 'sdtyule', 'sdu', 'sdtwutuan', 'shaodongtianqiyubao', 'shoudiantong', 'shuidoutupian', 'shandongtiyupindaozaixianzhibo', 'sandiantoushi', 'sdtgongsi']
amber	['ambershishenmeyisizhongwen', 'amberyingwenmingyuyi', 'amber alert', 'amber room', 'amberliuxianhua', 'amberyingwenming', 'amberzenmedu', 'amber label', 'ambergris']
BJLYFCYY	['beijingliyingfuchanyiyuandianhua', 'beijingliyingfuchanyiyuanjiage', 'beijingliyingfuchanyiyuanrenliu', 'beijingliyingfuchanyiyuankoubei']
runjiangnan	['runjiangnan', 'runjiangnanzhaoyangdayuechengdian', 'runjiangnanlvxingshezenmeyang', 'runjiangnandaobi', 'runjiangnancantingzenmeyang', 'runjiangnanreshuiqifalangzhuanyong', 'runjiangnanjiudiandianhua']
DiaoYeniunan	['diaoyeniunan', 'diaoyeniunanshibaideyuanyin', 'diaoyeniunanchuangshiren', 'diaoyeniunanxianzhuang', 'diaoyeniunancaidanjiamubiao', 'diaoyeniunanjiage', 'diaoyeniunanguanbi', 'diaoyeniunanhuiyuan', 'diaoyeniunanshanghaijijiadian', 'diaoyeniunanchuangshirenjianjie']
xianaohui	['xianaohui', 'xianaohuizenmeyang']
招商银行	['zhaoshangyinhangetc', 'zhaoshangyinhangapp', 'zhaoshangyinhangxinyongkakefu', 'zhaoshangyinhangkefu', 'zhaoshangyinhangwangdian', 'zhaoshangyinhangxinyongka', 'zhaoshangyinhanggupiao', 'zhaoshangyinhangxinyongkadianhua', 'zhaoshangyinhangchuxuka', 'zhaoshangyinhangdianhua']
homeinns	['homeinnshenmeyisi']
XuePankaochuan	['xuepankaochuan', 'xuepankaochuanguanwang', 'xuepankaochuanlaobanshishui', 'xuepankaochuan(zhaoyangdayuechengdian)', 'xuepankaochuanweishenmejiaoxuepan', 'xuepankaochuan(lansegangwandian)', 'xuepankaochuan(zhaoyangdayuechengdian)wangyoupinglun', 'xuepankaochuanlansegangwandianhua', 'xuepankaochuan(taiyuandian)zenmeyang', 'xuepankaochuan(zhaoyangdayuechengdian)shanghugaikuang']
yingpaisijianshen	['yingpaisijianshen', 'yingpaisijianshenniankajiagebiao', 'yingpaisijianshenqicai', 'yingpaisijianshenjiage', 'yingpaisijianshendianhua', 'yingpaisijianshenzenmeyang', 'yingpaisijianshenqicaibaojia', 'yingpaisijianshenfang', 'yingpaisijianshenyuekajiagebiao', 'yingpaisijianshenshangshilema']
xiaojungan	['xiaochenggan', 'xiaojunganshishenme', 'xiaojunganjiamengfei', 'xiaojunganchuanchuanxiangjiamengpianju', 'xiaojunganshishenmebuwei', 'xiaojunganchuanchuanxiangjiage', 'xiaojungan', 'xiaojungan', 'xiaojungan jiameng.com', 'xiaojunganchuanchuanxiangjiamengfeiduoshao']
54	['5436zhenzhazhongjie', '5436', '543budui', '5436案jian', '54jun', '54shi', '540', '54suo', '549']
北京3Am无痕接发	['beijing3amwuhenjiefaduoshaoqian']
32bar	['32bardengyuduoshaompa']
shunshun	['shunshun', 'shunshunliuxue', 'shunshunlili', 'shunshunliuliudeyisi', 'shunshunliuliu', 'shunshunshun', 'shunshun儿', 'shunshun', 'shunshunfengkuaididanhaochaxun', 'shunshunlilitupian']
xiachixiashuan	['xiachixiashuan', 'xiachixiashuandezuofa', 'xiachixiashuanjiamengduoshaoqian', 'xiachixiashuantupian', 'xiachixiashuanxiahuoguojiamengfeixuduoshaoqian', 'xiachixiashuandizhi', 'xiachixiashuanruhejiamengdian', 'xiachixiashuandaili', 'xiachixiashuandejiameng', 'xiachixiashuancaidan']
jazzya	['jazzyajueshiwulaoban', 'jazzyaoxueduojiunengrumen']
3AM	['3ammeifa', '3amdegequ', '3amshenmeyisi', '3ammeifachuangshirenjieshao', '3ammeifajianjie', '3amgeci', '3ammeifajiage', '3am hair salon', '3amnvlang', '3ammo']
elephant1	['elephant14']
Jasmine	['jasmineyingwenming', 'jasmine flower', 'jasminezenmedu', 'jasmineshishenmeyisizhongwen', 'jasminegongzhu', 'jasmineyingwenmingduyin', 'jasmine village', 'jasminehezhangyixing', 'jasmineshenmeyisi', 'jasminechuqing']
MARTINI	['martinijiu', 'dry martini', 'martinijiuba', 'martiniche', 'martiniqueshineigeguojia', 'martinibaoshijie', 'martinishenmeyisi', 'martinizenmehe', 'martinijiweijiu', 'martini racing']
InterContinental	['intercontinentalshanghai', 'intercontinentalzhoujijiudian', 'intercontinentalbeijing', 'intercontinentalxianggang', 'intercontinental hotelshanghai', 'intercontinental wuxi', 'intercontinental chengdu', 'intercontinentalzenmedu', 'intercontinentalfanyi', 'intercontinentalchengdu']
张妈妈	['zhangmamatesechuanweiguan', 'zhangnuonuo', 'zhangmamatesechuancaiguan', 'zhangmamalaoshi', 'zhangmamachufangxiangtiaoshishipin', 'zhangmamachufang', 'zhangmamaxiaochaozenmezuo', 'zhangmamadechufangshipu', 'zhangmamadedianxin', 'zhangmamayangtangnengjiamengma']
LLJ	['lilianjie', 'linlijinzhi', 'lunliju', 'lilianjiedianying', 'linjunjie', 'lilianjiexianzaidezhenshixianzhuang', 'lilongji', 'liulingjunsaoyoukongjian', 'liangliangjianpu']
柑鹿	['ganlujiuba', 'beijingjianjiaganlu']
云川台球三里屯店	['yunchuantaiqiusanlitundiandianhua']
walahuoguo	['walahuoguo', 'walahuoguozenmeyang']
1001night	['1001nights']
CHAO	['chaoshenjixieshi', 'chaojidaletou', 'chaohua', 'chaos', 'chaoxian', 'chaojifeixia', 'chaoren', 'chaoshan', 'chaoti', 'chaopai']
HomeInns	['homeinnshenmeyisi']
BRACKET	['bracketshishenmeyisizhongwenfanyi', 'bracketshenmeyisi', 'bracket coffee', 'bracketzenmedu', 'in bracket', 'tax bracket', 'bracketzenmeji', 'bracketshuxuefanyi', 'bracketheparentheses', 'bracketjianpan']
Moonshine	['moonshineshishenmeyisi', 'moonshiner', 'moonshinechajian', 'moonshinechangban', 'moonshinejiuba', 'moonshine valley', 'moonshinezuoqu', 'moonshinezhongwenyisi', 'moonshinezuoqujia', 'bar moonshine']
sanfulong	['sanfulongjing fuqing', 'sanfulongjinglongtinghuxingtu', 'sanfulongjing二shoufangmaopifang', 'sanfulongtingduoshaoyipingfang', 'sanfulongjingkaifashangshishui']
小七君私房菜	['xiaoqijunsifangcaizenmeyang', 'xiaoqijunsifangcai(jintailudian)', 'xiaoqijunsifangcai(gongtidian)zenmeyang', 'xiaoqijunsifangcaiguanwang', 'xiaoqijunsifangcai(gongtidian)', 'xiaoqijunsifangcai(jintailudian)zenmeyang', 'xiaoqijunsifangcai dazhongdianping']
caixin	['caixin', 'caixinwang', 'caixindezuofa', 'caixingjuan', 'caixin', 'caixinfazhan', 'caixinzenmezuohaochi', 'caixin', 'caixin', 'caixinjituan']
mizuki	['mizuki ruikuijiehunlema', 'mizuki ruikuizhenshixingming', 'mizukimaodao', 'aliez zeyehongzhimizuki', 'kazuomihemizuki', 'riyu mizuki']
YJXCGY	['yujingxinchenggongyu', 'yangjixingchouguiyuhengtaidian', 'yangjixingchouguiyuhengtaiguangchang', 'yangjixingchouguiyuchanghongqiaodian', 'yangjixingchouguiyuguanwangzhaopin', 'yangjixingchouguiyugaomidian', 'yangjixingchouguiyuzenmeyang', 'yangjixingchouguiyudezuofa', 'yangjixingchouguiyulianxiangqiaodian']
HaiDiLaoHuoGuo	['haidilaohuoguo', 'haidilaohuoguozhanliao', 'haidilaohuoguojiagebiao', 'haidilaohuoguojiamengfeiduoshao', 'haidilaohuoguodiliao', 'haidilaohuoguojiameng', 'haidilaohuoguodiliaochangjia', 'haidilaohuoguoxueshengzheng69zheshijian', 'haidilaohuoguo buyashipin', 'haidilaohuoguoshizizhuma']
Toybox	['toy boxshenmeyisi', 'toy boxzenmedu', 'toy boxzuhe', 'toyboxshenmeyisizhongwen', 'toyboxzuhedjwuqushipin', 'toyboxyingyuzenmedu', 'toyboxkongbuyouxi', 'toyboxzenmeduyinfayin', 'toyboxgequdaquan', 'toy boxzuhegequ']
NiaoTun	['niaotunmu', 'niaotunmudipinyin', 'niaotunmukonglong', 'niaotunleikonglong', 'niaotundepinyinzenmedu', 'niaotunzenmedu', 'niaotuntuzi', 'niaotunmudiyisi', 'niaotun', 'niaotun']
shijiajingpin	['shijiajingpinjiudianyuding', 'shijiajingpinjiudiandianhua', 'shijiajingpinjiudianzenmeyang', 'shijiajingpinjiudian(kenlidian)zenmeyang', 'shijiajingpinjiudiantuanjiehu', 'shijiajingpinchaoshizenmeyang', 'shijiajingpinshoubanzenmeyangzenmeyang', 'shijiajingpinjiudianzhaopin']
CINKERCINEMAS	['cinkercinemassankeyingyuanzenmeyang', 'cinkercinemas(sanlitundian)zenmeyang', 'cinkercinemas(sanlitundian) gaikuang', 'cinkercinemas(sanlitundian) pinglun']
西部马华	['xibumahuajianjie', 'xibumahuahuiyuan', 'xibumahuacantingcaidan', 'xibumahuabeijingyouduoshaodian', 'xibumahuashiqingzhencantingma', 'xibumahuashifu', 'xibumahuaweigongqiaodian', 'xibumahualamianjiameng', 'xibumahualamianchuangshiren', 'xibumahualamianbeijingsuoyoudianmian']
super8	['super8mm', 'sikedasuper8', 'super8jiudianguanwang', 'super8sheyingji', 'super8jiaojuan', 'super8jiudian', 'super888bbb', 'super8youxi', 'kedasuper8']
yanweidie	['yanweidie', 'yanweidiegeci', 'yanweidietupian', 'yanweidiedeyuyi', 'yanweidiedegequ', 'yanweidiekunchong', 'yanweidiedianyingwanzhengbanzaixianguankan', 'yanweidiexiaoshuo', 'yanweidieloveweibo', 'yanweidiezuozhe']
xiaohongpaoS	['xiaohongpaoshishenmecha', 'xiaohongpaosunxiuyingyanchangquanji', 'xiaohongpaoshihongchahaishilvcha', 'xiaohongpaoshishenmeyisi', 'xiaohongpaoshishenmecha?', 'xiaohongpaoshiwumidechengjishijiufenhaishimiaohaishishi', 'xiaohongpaosaidoushidaoshudiyi', 'xiaohongpaoshizinaliyou', 'xiaohongpaoshuyuhongchama']
WEST	['western', 'western blot', 'westin', 'westwood', 'westray', 'westshenmeyisi', 'west lifedezhuchangshishui', 'westpac', 'westinjiudian', 'west hill']
麻辣男女	['malanannvhuoguojiameng', 'malanannvhuoguozongdian']
shuilintianyue	['shuilintianyue歺paijiage', 'shuilintianyuejiuba dongdaqiao']
SIR.TEEN	['sirteenjiuba', 'sirteensankemenpiao', 'sirteenshishishenmeyisi', 'sirteenjiubaxiaofei', 'sirteenfanyizhongwen', 'sirteenjidiankaimen', 'sirteenkazuoduoda', 'sirteensantaidixiao', 'shisanxianshengsirteen', 'gongtisirteen']
bluefrog	['blue froglanwa', 'blue froglanwacaidan', 'blue frog menu', 'blue froglanwa guomao', 'blue froglanwachuangshiren', 'blue frogdangci']
BakerandSpice	['bakerandspice heimaimianbao100%', 'bakerandspice beijing']
MCD-ChinaNet	['mcd-chinanetyanzhengyemian', 'mcd-chinanetzenmelianjie', 'mcd-chinanetlianbushang', 'mcd-chinanetmaidanglao', 'mcd-chinanetshoufeima', 'mcd-chinanetshishenme']
D-one	['doneshenmeyisizhongwenfanyi', 'doneshishenmeyisi', 'donezenmeduyin', 'doneshiguoqufencima', 'doneshidodeshenmexingshi', 'done for me', 'doneshishenmeshitai', 'donesiashineigeguojia', 'doner', 'doneshenmeyisizhongwen']
zhaolonghotel	['zhaolonghotelbeijing.cn']
MUSE	['muse', 'museum', 'muse dash', 'museumzenmeduyin', 'museums', 'museshenmeshenmechengyu', 'musejiuba', 'museumshishenmeyisi', 'museka', 'muse dashpojieban']
LOFT	['lofter', 'loftgongyu', 'loftshenmeyisi', 'lofterguanwang', 'lofty', 'lofterwangyeban', 'lofthuxing', 'loftcenggao', 'loftchanquan']
xiaogechuanchuan	['xiaogechuanchuanxiang(sanlitundian)zenmeyang', 'xiaogechuanchuanxiang(yinheSOHOdian)zenmeyang', 'xiaogechuanchuanxiang(huilongguandian)zenmeyang', 'xiaogechuanchuanxiang(jinyuandian)zenmeyang', 'xiaogechuanchuanxiang(yinheSOHOdian)']
carmen	['carmendeyisi', 'carmenyingwenming', 'carmenhongjiu', 'carmenzenmedu', 'carmenshinvshengmingma', 'carmen cuesta', 'carmengeju', 'carmen suite', 'carmencanting', 'carmenfandian']
有家生煎	['youjiashengjian(sanlitundian)zenmeyang', 'youjiashengjian(sanlitundian)', 'youjiashengjian(sanlitundian)shanghugaikuang', 'youjiashengjiankeyijiamengma']
dk1308	['dk1308yinyuemeishicheng', 'dk1308huangguanziniangpijiufang', 'dk1308xicanting']
dipingxian	['dipingxian', 'dipingxian4', 'dipingxianmotuoche', 'dipingxian3', 'dipingxiangonglve', 'dipingxianyingwen', 'dipingxiangongsi', 'dipingxianlingzhishuguang', 'dipingxianjiqiren', 'dipingxianmotuochejiage']
Ginger	['gingerbread', 'gingerzenmeduyin', 'ginger ale', 'gingershenmeyisi', 'gingerly', 'ginger doll', 'ginger root', 'gingeryinbiao']
elephant	['elephant zenmedu', 'elephantshenmeyisisi', 'elephantshishenmeyisizhongwen', 'elephant in the room', 'elephantshenmeyisi', 'elephantdeyinbiao', 'an elephant', 'elephant house', 'elephantzhandui', 'elephant seal']
niaotun	['niaotunmu', 'niaotunmudipinyin', 'niaotunmukonglong', 'niaotunleikonglong', 'niaotundepinyinzenmedu', 'niaotunzenmedu', 'niaotuntuzi', 'niaotunmudiyisi', 'niaotun', 'niaotun']
rijin	['rijin', 'rijindoujin', 'rijingzhishu', 'rijingjin', 'rijing', 'rijinchang安yuan', 'rijingda', 'rijindushenmezi', 'rijing', 'rijindoujinyisi']
小小美甲	['xiaoxiaomeijiadian', 'xiaoxiaomeijiaweibo', 'xiaoxiaomeijialansegangwandianhua', 'sanlitunxiaoxiaomeijia', '爱xiaoxiaomeijia', '瓯beixiaoxiaomeijia', 'lansegangwanxiaoxiaomeijia', 'xiaoxiaomeijiameijie(sanlitundian)', 'xiaoxiaomeijiajiamengfeiduoshao', 'xiaoxiaomeijiameijie(sanlitundian) gaikuang']
didiao	['didiao', 'didiaozuhe', 'didiaokanzhibo', 'didiaogaoshou', 'didiaotupian', 'didiaoshehua', 'didiaoyingwen', 'didiaoshushi', 'didiaozuorengaodiaozuoshishenmeyisi', 'didiaodeche']
LaoTie	['laotie', 'laotie', 'laotieshishenmeyisi', 'laotietou', 'laotieshipinxiazai', 'laotietoushe', 'laotiewotainanle', 'laotieshan', 'laotiedianyingwangchenqingling', 'laotieshipinxiazaimianfei安zhuang']
shangbangdaisi	['shangbangdaisijingpinjiudian', 'shangbangdaisijiudianguanligongsi', 'shangbangdaisiwenquanjiudian', 'shangbangdaisijiudianwangping', 'shangbangdaisijiudianguanlijituanzenmeyang', 'shangbangdaisizhutijingpinjiudianzenmeyang', 'shangbangdaisi(beijing)jiudianguanliyouxiangongsi', 'shangbangdaisijiudianbeijinggongsi', 'shangbangdaisijiudianguanlijituan']
Playhouse	['playhousejiuba', 'playhousechengdu', 'playhouseshenmeyisi', 'playhousechangsha', 'playhousebeijing', 'dalianplayhouse', 'playhousexi安', 'playhousezenmedu', 'playhousewangjia尔', 'playhousejiubachuangshiren']
拿铁酒吧	['natiejiubalaobanbeijing', 'linyinatiejiuba', 'qiqiha尔natiejiuba', 'sanlitunnatiejiuba', 'ha尔binshengtiannatiejiuba', 'gongtinatiejiuba', 'gongticlnatiejiuba', 'linyishinatiejiuba', 'kunmingnatiejiuba', 'manzhoulinatiejiuba']
世家精品酒店	['shijiajingpinjiudianyuding', 'shijiajingpinjiudiandianhua', 'baolishijiajingpinjiudian', 'yiningshishijiajingpinjiudian', 'dehongshijiajingpinjiudian', 'shijiajingpinjiudianzenmeyang', 'shijiajingpinjiudian(kenlidian)zenmeyang', 'shijiajingpinjiudiantuanjiehu', 'shijiajingpinjiudianzhaopin', 'shijiajingpinjiudiancongtuanjiehuneigechukouchu']
QMEX	['qmex beijing', 'qiumin儿xiangyequanwenyuedu', 'qimu而xi', 'quanma恶xin', 'qumu尔xia', 'qiaomu恩xiaoshuo', 'qiumu耳xuyaopaoduojiu', 'qianmei儿xuejixijingyou', 'qiaomi儿xiezhuangshuihaoma', 'qiaomi儿xiezhuangshui']
柒.LOUNGE	['beijingsanlitunqilounge']
xiaochunrihe	['xiaochunrihe', 'xiaochunrihelousimao', 'xiaochunrihelounuomaotx', 'xiaochunrihe lounuomaoweipan', 'xiaochunrihelousimaobaiduyun', 'xiaochunrihelousimaoshubao', 'xiaochunrihe lounuomaotxt', 'xiaochunrihebylousimao']
velvet	['red velvet', 'velvety', 'velvetyisi', 'velvetshishenmepaizikouhong', 'velvet matte', 'velveteen', 'velvetzenmeduyin', 'velvet teddy', 'velvet cherry', 'velvet rose']
Knight魔术酒吧	['knightmoshujiubafujintingchechang', 'knightmoshujiubaxiaofei']
republic	['republic of korea', 'republic of chinashenmeyisi', 'republicshenmeyisi', 'republic of game', 'republiczenmedu', 'republic of singapore', 'republic of the philippines', 'republication', 'one republic']
huangmen	['huangmenji', 'huangmengying', 'huangmenjimifan', 'huangmenjizuofa', 'huangmen', 'huangmenpaigu', 'huangmenyangrou', 'huangmenniurou', 'huangmenjimifanzuofa', 'huangmen']
Scandal	['scandalous', 'scandal and liber', 'scandalxiangshuishenmepaizi', 'scandalize', 'sandal', 'scandalousxiangshuiduoshaoqian', 'libel', 'liber', 'scandal xiangshui']
XLKHG	['xiaolongkanhuoguo', 'xiaolongkanhuoguodianjiameng', 'xiaolongkanhuoguocaidanjiamubiao', 'xiaolongkanhuoguozenmeyang', 'xiaolongkanhuoguojiageguibugui', 'xiaolongkanhuoguonalide', 'xiaolongkanhuoguoxuanchuanyu', 'xiaolongkanhuoguorenjunjiage', 'xiaolongkanhuoguodeguo', 'xiaolongkanhuoguodianping100zi']
BOTTEGA	['bottegashishenmepaizi', 'bottegaguanwang', 'bottegajiu', 'bottegaxie', 'bottegashoutibao', 'bottegaxiangshui', 'botegaveneta', 'bottegaqianbao', 'bottegaxiangbin', 'bottegazenmedu']
爸爸烤肉	['babakaoroulingengxin', 'babakaoroulingengxinkainali', 'babakaoroudian', 'babakaoroushishuikaide', 'babakaorouduoshaoqian', 'babakaorouyingyeshijian', 'babakaorouxinyuandian', 'babakaorouwangshangquhao', 'babakaoroudianrenjunduoshao', 'babakaoroudiandizhishanghai']
DK1308	['dk1308yinyuemeishicheng', 'dk1308huangguanziniangpijiufang', 'dk1308xicanting']
jinguixiaoshancheng	['jinguixiaoshancheng', 'jinguixiaoshanchengniuwa', 'jinguixiaoshancheng chunxiulu', 'jinguixiaoshancheng(yayuncundian)zenmeyang', 'jinguixiaoshancheng(nanhudongludian)zenmeyang', 'jinguixiaoshancheng(guijieyidian)zenmeyang', 'jinguixiaoshancheng(qinhuangdajiedian)zenmeyang', 'jinguixiaoshancheng(guijiezongdian)zenmeyang', 'jinguixiaoshancheng(zongdian)shanghugaikuang', 'jinguixiaoshanchenghuoguoxiuzenmeyang']
cows	['cowszenmedu', 'cowsshishenmeyisi', 'cowsshishenmeyisizhongwen', 'crows', 'cowskin', 'coward', 'cowshedshishenmepaizi', 'cowsyingyuzenmedu', 'cowsin']
bodhi	['bodhisattva', 'bodhi jones', 'boshi', 'boshidun', 'bodhishishenmeyisi', 'bodhidharma', 'bodhisattvashenmeyisi', 'bodhizhongchoupingtai', 'boshi', 'boshidundaxue']
Cargo	['cargoshenmeyisizhongwen', 'cargo pants', 'cargo tracking', 'cargo receipt', 'cargoshishenmepaizide', 'cargo ship', 'cargos', 'carbon', 'car2go', 'cargo shorts']
同心阁	['tongxingedianhuahaoma', 'tongxingedingcandianhua', 'tongxinge二shoufang', 'tongxingefandian', 'tongxingefandianzenmeyang', 'jinhuashixiandaitongxinge', 'qingyuntongxinge', 'feidongtongxinge']
R-kiss	['weixinairkiss', 'ruikui5 5200ushangshishijian', '1srkiss']
ONETHIRD	['one thirdjiuba', 'one thirdhangzhou', 'one thirdbeijing', 'one thirdshenmeyisi', 'one third of', 'one thirdshishenmeyisizhongwen', 'one third club', 'one thirdjiubahangzhou', 'one third of the population', 'one third xiaofeishuiping']
njdpd	['nanjingdapaidangzaina', 'nanjingdapaidangzongbudianhua', 'nanjingdapaidang', 'nanjingdupengdahuojiweixiudian', 'nanjingdapaidang', 'nanjingdapaidangbidiandecai', 'nanjingdapaidangbaobingniurousong', 'nanjingdapaidangbaitianyingyema', 'nanjingdaopudongguojijichang', 'nanjingdapaidangbidiancaituijian']
LetsBURGERplus	['letsburgerplus caidan', 'letsburgerplus langang', 'letsburgerpluszenmedu', 'letsburgerplusshijiamengdianma', 'letsburgerpluswanghong', 'letsburgerplusjiage', 'letsburgerplustianjin', 'letsburgerplus shanghai']
bajianchuan	['bajianchuangxinrencaishiyanban', 'bajianchuanjujiuwu', 'bajianchuanchuanjiameng', 'bajianchuangxinrencaipeiyangmoshi', 'bajianchuanchuandebaoyushisha', 'bajianchuan', 'bajianchuanshuozhongdichuju']
tongxinge	['tongxinge', 'tongxingeshou', 'tongxingedianhuahaoma', 'tongxinge', 'tongxing耳huandaineige耳duo', 'tongxing二juti', 'tongxingerengongzuojianli', 'tongxingeshoujibanxiazai', 'tongxing儿tongshuzhuo安zhuangfangfa', 'tongxingendangzoushouchaobao']
laotao	['laotao', 'laotao', 'laotailongzhong', 'laotaotong', 'laotaoshishenmeyisi', 'laotaomao', 'laotaipo', 'laotaomaoupanzhongzhuangxitongjiaocheng', 'laotaotongbuqiang', 'laotaofu']
yuebeixiaocheng	['yuebeixiaocheng(sanlitunshimaodian)zenmeyang', 'yuebeixiaochengshimaobaihuodianzenmeyang', 'yuebeixiaocheng(shimaobaihuodian)', 'yuebeixiaocheng·chaoshanshaguozhouzenmeyang']
XDHDSJ	['xidinghaidanshuijiaonaliyou', 'xidinghaidanshuijiaobaiweinian', 'xiadonghaidianshiju', 'xiandaihuadushijianbihua', 'xiedonghudeshiju', 'xiudouhuadishijijuqing', 'xiandaihuadaishuji', 'xingdanhuadeshijiezaixian', 'xiedaihuadeshiju', 'xiedehaodeshijiejindaishi']
神坛小馆	['shentanxiaoguan(sanlitundian)zenmeyang']
大龙燚火锅	['dalongyihuoguozenmeyang', 'dalongyaohuoguoguanwang', 'dalongyihuoguolaoban', 'dalongyaohuoguotuijian', 'dalongyihuoguodian', 'dalongyihuoguo(taigulidian)zenmeyang', 'dalongyihuoguo(dongmennandian)zenmeyang', 'dalongyihuoguo(zhujiangxinchengdian)zenmeyang', 'dalongyihuoguo(fenxiangdian)zenmeyang', 'dalongyihuoguo(chunxidian)zenmeyang']
ZWYN	['zhiwuyouneixie', 'zhongwenyuenanyuhuyi', 'zhiwuyouneixiemingzi', 'zhiwuyounazhongyouyingyangzuigao', 'zhiwuyangnainaitupiandaquan', 'zhongweiyouneixiedaxue', 'zhiwuyangnainaidegongxiao', 'zhongwanyanengchiliulianma', 'zuowanyunnansharen案', 'zhiwenyounajigexitongzucheng']
THESECRET	['the secret to', 'the secret of', 'the secret life of pet', 'the secret life of walter', 'the secret life of pet2', 'the secret to doing', 'the secret of beautyzaixianguankan', 'the secret gardenfanyi', 'the secret of success', 'the secret gardenyuanwen']
桥底串吧	['qiaodichuanbadelaobanshishui', 'qiaodichuanbalaobanhanshibo', 'qiaodichuanbasigegudong', 'qiaodichuanbachuangshiren', 'qiaodichuanbalaobanwangshuai', 'qiaodichuanbazenmeyang', 'qingdaoqiaodichuanba', 'batiyaqiaodichuanba', 'sanyaqiaodichuanba', 'wangshuaiqiaodichuanba']
ROOF	['roofshishenmeyisi', 'rooftop', 'roofs', 'rooffushu', 'proof', 'rooftoukui', 'roofed', 'roofzhifang', 'root']
RestaurantY	['restaurantyouxi', 'restaurantyingyuzenmedu', 'restaurantyinbiao', 'restaurantyisi', 'restaurantyingyuzenmeduyuyin', 'restaurantyingyu', 'restaurantyinjiehuafen', 'restaurantyongyingyudu', 'restaurantyingyufanyi', 'restaurantyingyinmeiyin']
Shuilintianyue	['shuilintianyue歺paijiage', 'shuilintianyuejiuba dongdaqiao']
PacificCoffee	['pacificcoffee奥yuandian', 'pacificcoffeedayuecheng-huolitiyanguanzenmeyang', 'pacificcoffeeshenzhen', 'pacificcoffeezenmedu', 'pacificcoffeeyuebing', 'pacificcoffeejiage', 'pacificcoffee(dayuechengdian)zenmeyang']
Amo	['among', 'amount', '阿moxilin', 'amor', 'amoy', 'amoled', 'amos', 'amore', 'amongst', '阿moxilinkelaweisuanjia']
Vplus	['vplusjiuba', 'vplushuiyuan shenmeyisi', 'vplusyifu', 'vplusyanjing', 'yiwanvheyiwanvplus', 'beijingvplus', 'cvplus', 'kovplus', 'mangguotvplus']
instyle	['instylezaoxingjiamubiao', 'instylezaoxing', 'instylezhongwenshishenmeyisi', 'instyleshishenmepaizi', 'instylezaoxingguanwang', 'instylechuangshiren', 'instylemeifachuangshiren', 'instylelifadian', 'instyleyoujiahuabao', 'instyleshenmeyisi']
Buerjiuguan	['bu二jiuguanzenmeyang', 'bu二jiuguansisiyufan']
REDREAM	['redreammoniqi安zhuoban', 'redreammoniqi', 'redream安zhuo', 'shanghairedream']
YingLanQuanXi	['yinglanquanxiyangshengguanzhengguime', 'yinglanquanxiyangshengguanzenmeyang', 'yinglanquanxiyangshengguan pinglun', 'yinglanquanxiyangshengguanzhengguima', 'yinglanquanxiyangshengguan dongzhimenwaidajie']
Anchor	['anchorshishenmeyisizhongwen', 'anchorage', 'anchornaifenzenmeyang', 'news anchor', 'the anchor', 'anchorgeci', 'anchorzixingche', 'anchor free', 'anchor chart', 'anchor point']
马路牙子地桌烤肉	['maluyazidizhuokaorou(gongtidian)yonghupinglun', 'maluyazidizhuokaoroujiameng', 'wangjingmaluyazidizhuokaorou', 'maluyazidizhuokaorou(gongtidian)shanghugaikuang', 'beijingmaluyazidizhuokaorou', 'maluyazidizhuokaorou(gongtidian) gaikuang', 'maluyazidizhuokaorou(gongtidian)zenmeyang', 'maluyazidizhuokaoroumima']
pintec	['pintech', 'pintecjituan', 'pintecpintai daiyu', 'pintecpintai', 'pintecpintaijiabanqingkuang', 'spintec']
mubei	['mubei', 'mubeizaoxing', 'mubei', 'mubei', 'mubeitupian', 'mubeigeshi', 'mubeixian', 'mubeibeiwen', 'mubeihufuzaoxing', 'nuobei尔']
北京长虹医院	['beijingchanghongyiyuanshizhengguiyiyuanma', 'beijingchanghongyiyuanzenmeyang', 'beijingchanghongyiyuandizhi', 'beijingchanghongyiyuandianhua', 'beijingchanghongyiyuanzhengronghaoma', 'beijingchanghongyiyuankekaoma', 'beijingchanghongyiyuanshisilidehaishiguojiade', 'beijingchanghongyiyuantupian', 'beijingchanghongyiyuanzhaopinxinxi', 'beijingchanghongyiyuandizhidianhua']
李嘉嘉	['lijiajiachuanchuanxiang', 'lijiajiachuanchuan', 'lijiajiagerenziliao', 'lijiajiachuanchuanxiangshuikaide', 'lijiajiachuanchuanxianghuoguo', 'lijiajia', 'lijiajiachuanchuanxiangkeyijiameng', 'lijiajiachuanchuanxiangduoshaoqian', 'lijiajiachuanchuanxiangjianjie', 'lijiajiachuanchuanhuoguozenmeyang']
OneThird	['one thirdjiuba', 'one thirdhangzhou', 'one thirdbeijing', 'one thirdshenmeyisi', 'one third of', 'one thirdshishenmeyisizhongwen', 'one third club', 'one thirdjiubahangzhou', 'one third of the population', 'one third xiaofeishuiping']
TheBeastShop	['thebeastshop scm']
bianyifang	['pianyifang', 'pianyifangkaoya', 'pianyifangzenmedu', 'pianyifangzongdian', 'pianyifangkaoyaduoshaoqianyizhi', 'pianyifangkaoyahequanjudekaoyadequbie', 'pianyifangkaoyadian', 'pianyifangkaoyajiamubiao', 'pianyifangkaoyadianzongdiandizhi', 'pianyifanghequanjudenajiahao']
CJIA	['cjia', 'changjiang', 'changjiangdaxue', 'cjiasu', 'cjiajia', 'cjiazhaonengkaishenmeche', 'changjiangshangxueyuan', 'changjiangsanxia', 'changjiangqihao', 'changjiangyuantou']
xiaozhang	['xiaozhang', 'xiaozhangfu', 'xiaozhang', 'xiaozhangxiaozhang', 'xiaozhan', 'xiaozhangwuzhe', 'xiaozhanglang', 'xiaozhangyu', 'xiaozhangbangongshi', 'xiaozhangbahu']
HUAXING	['huaxing', 'huaxingguangdian', 'huaxingziben', 'huaxing', 'huaxingyuanchuang', 'huaxingyinhang', 'huaxingchuangye', 'huaxingche', 'huaxingxiongdi', 'huaxin']
rongshangzaoxing	['rongshangzaoxing', 'rongshangzaoxing(gongtibeiluyidian)zenmeyang', 'rongshangzaoxing(gongtibeiluyidian)', 'rongshangzaoxing(gongtibeiluyidian) pinglun', 'rongshangzaoxing(gongtibeilu二dian)zenmeyang']
怪兽串场	['guaishouchuanchangChili Monsterzenmeyang']
dongfangliang	['dongfangliang', 'dongfangliangcaijingmijishuyouxiangongsi', 'dongfangliangcai', 'dongfangliangcaikejiyouxiangongsi', 'dongfanglianghuachengzhanglinghuo005616jingzhi', 'dongfangliangcaizenmeyang', 'dongfangliangcaijingmijishuyouxiangongsizenmeyang', 'dongfangliangcaizhaopin', 'dongfangliangxiaomi', 'dongfanglianghuachengzhang']
TheRug	['therugwangfuzhonghuandian']
dazhangfu	['dazhangfu', 'dazhangfudianshijuquanji48', 'dazhangfuriji', 'dazhangfu2', 'dazhangfuxiaoxifu', 'dazhangfunengqunengshen', 'dazhangfushenmeyisi', 'dazhangfuriyu', 'dazhangfushengyutiandijian qinengjiujurenxia', 'dazhangfudangdaisanchizhijianlibushizhigong']
shaoxiashi	['shaoxiashizongbuzainali', 'shaoxiashiliuqi', 'gongtishaoxiashi', 'shaoxiashifuduoshaoqianyigeyue', 'shaoxiashijian', 'shaoxiashishenmeyisi', 'shaoxiashi', 'shaoxiashi dazhongdianping', 'shaoxiashizenmeyang', 'shaoxiashijiamengliansuodian']
ifensi	['ifensidianshihezimima', 'ifensi hezi app', 'ifensijidinghezhuangruanjian', 'ifensijidinghezenmeyong', 'ifensifensijidinghe安zhuang']
Caixin	['caixin', 'caixinwang', 'caixindezuofa', 'caixingjuan', 'caixin', 'caixinfazhan', 'caixinzenmezuohaochi', 'caixin', 'caixin', 'caixinjituan']
ShiTangZui	['shitangzuihaodedaxue', 'shitangzuihaochidedaxue', 'shitangzuiduodedaxue', 'shitangzui', 'shitangzuixincaipintupian', 'shitangzuiduodedaxuepaihang', 'shitangzuipianyidedaxue', 'shitangzuirongyichuxiandewenti', 'shitangzuihaodedaxuepaiming', 'shitangzuiqiangdadehouqinbaozhang']
Hacker-Pschorr	['hackerpschorryurenmatouyuedui', 'hackerpschorrkafei']
aojiameishuguanjiudian	['奥jiameishuguanjiudian', '奥jiameishuguanjiudianyezonghui', '奥jiameishuguanjiudiandianhua', '奥jiameishuguanjiudianditie', '奥jiameishuguanjiudian-dimiantingchechangzenmeyang', '澳jiameishuguanjiudiandixiaKTVjiaoshenme', '奥jiameishuguanjiudian(dongzhimenwaidajie26hao)', '奥jiameishuguanjiudiandelaozongshishui?', '奥jiameishuguanjiudiandaonanyingtaoyuanlukounan', '奥jiameishuguanjiudianliditiekouduoyuan']
sushitong	['sushitong', 'sishitongtang', 'sushitong', 'sushitong', 'sushitongshidaishirenyouneixie', 'sushitong', 'sushitongkejinshiyouneixie', 'sushitongcanyinguanlixitong', 'sushitongshushenmezhilie', 'sushitongyizimimiaozainali']
rampage	['rampagedianying', 'rampageshishenmeyisi', 'rampageshishenmepaizi', 'rampageyouxi', 'the rampage', 'rampage v extreme', 'rampage exile', 'rampage movie', 'rampage from exile', 'rampage iii extreme']
Velvet	['red velvet', 'velvety', 'velvetyisi', 'velvetshishenmepaizikouhong', 'velvet matte', 'velveteen', 'velvetzenmeduyin', 'velvet teddy', 'velvet cherry', 'velvet rose']
bookworm	['bookwormshishenmeyisi啊', 'bookwormzenmedu', 'bookworm beijing', 'bookwormgangbi', 'bookwormshenmepaizi', 'bookworm shishenme', 'the bookworm', 'oxford bookworm', 'the oxford bookworm']
HUAZHU_Hanting	['huazhuhantingjiudianshujuxielou', 'huazhuhanting', 'huazhuhantingshangwangdengludizhi', 'huazhuhantingningbo', 'huazhuhantingshizhi', 'huazhuhantingjiudian', 'huazhuhantingwifidengluyemian', 'huazhuhantingguanwang', 'huazhuhantingjiudianwifimima', 'huazhuhantingkefudianhua']
HaiDiLaoDianCai	['haidilaodiancai', 'haidilaodiancaigonglvesiren', 'haidilaodiancaidepingbanzayong', 'haidilaodiancaigonglve3ren', 'haidilaodiancaigonglve2ren', 'haidilaodiancaixitong', 'haidilaodiancaixuyaozhucema', 'haidilaodiancaigonglve', 'haidilaodiancaidoushiipad', 'haidilaodiancaidan']
请晋山西餐社	['qingjinshanxicanshe(haoyunjiedian)zenmeyang', 'qingjinshanxicanshe(sanlitunshiguanglieche)zenmeyang', 'qingjinshanxicanshe(haoyunjiedian)', 'qingjinshanxicanshe(sanlitunshiguangliechedian)', 'qingjinshanxicanshelaoban', 'qingjinshanxicanshesanlitun', 'qingjinshanxicanshejiameng']
Algorithm	['algorithmshishenmeyisi', 'algorithmic', 'algorithm negotiation fail', 'algorithmtouwenjian', 'algorithmfanyi', 'algorithmqikan', 'algorithmlaiyuan', 'algorithmchangyonghanshu', 'algorithmic trading', 'algorithmhanshu']
haolinju	['haolinjudeshuoshuo', 'haolinju', 'haolinjuzhizhuxia', 'haolinjufangchan', 'haolinjudianyingjiangshudeshenme', 'haolinjuchaoshi', 'haolinjuchaoshijiamengfei', 'haolinjufangchanlianmeng denglu', 'haolinjutupian', 'haolinjubianlidian']
wangjingxiaoyao	['wangjingxiaoyaojiameng', 'wangjingxiaoyaozenmeyang', 'wangjingxiaoyaojiamengduoshaoqian', 'wangjingxiaoyaonajiashizhende', 'wangjingxiaoyaoshishenmeyaozi', 'wangjingxiaoyaozuofa', 'wangjingxiaoyaozongdian', 'wangjingxiaoyaotupian', 'wangjingxiaoyaozongdianzaina', 'wangjingxiaoyao']
zhaolong-hotel	['zhaolonghotelbeijing.cn']
yinyuetai.com	['yinyuetai.com Yinyuetai', 'yinyuetai.com yinyuetai', 'yinyuetai.com Facezhongwenzimurenrenban--yinyueTai_222', 'yinyuetai.com/video/3298430', 'yinyuetai.comyidainvhuang']
速8	['su8jiudian', 'su8jiudianjiage', 'su8jiudiandianhua', 'su8huiyuan', 'su8dianhua', 'su8kuaidi', 'su8jiudiandianhuakefudianhua', 'su8jiudianzenmeyang', 'su8jiudianjiameng']
thebell	['thebellshishenmeyisi']
Revolution	['revolutionary', 'revolutionjitapu', 'revolutionshishenmeyisi', 'revolutionguanwang', 'revolutionjiuba', 'revolutionjita', 'revolutionzhitan', 'revolutiongeci', 'revolution ct', 'revolutiongequ']
黑泷太郎	['heilongtailangjiamengfeiduoshao', 'heilongtailangguanwang', 'heilongtailangpinpaijieshao', 'heilongtailangheheilongtang', 'heilongtailangcaidan', 'heilongtailangheyidiandian', 'heilongtailangnaichaneigehaohe', 'heilongtailangtupian', 'heilongtailangzongbuzainali', 'heilongtailang baike']
珍滋味港式粥火锅	['zhenziweigangshizhouhuoguocaidan', 'beijingzhenziweigangshizhouhuoguo', 'zhenziweigangshizhouhuoguo(gongtidian)', 'zhenziweigangshizhouhuoguojiameng', 'zhenziweigangshizhouhuoguo(xinyuanxilidian)zenmeyang', 'zhenziweigangshizhouhuoguoguanwang', 'zhenziweigangshizhouhuoguozenmeyang', 'zhenziweigangshizhouhuoguo(gongtidian)shanghugaikuang', 'zhenziweigangshizhouhuoguojiage', 'zhenziweigangshizhouhuoguo(gongtidian)wangyoupinglun']
WeWork	['weworkshanghai', 'weworkbeijing', 'weworkguanwang', 'weworkshishenmegongsi', 'weworkshenzhen', 'weworkchengdu', 'weworkhangzhou', 'weworkzhaopin', 'weworkshenmeyisi', 'weworkguangzhou']
THERUG	['therugwangfuzhonghuandian']
STAFOOD	['stafoodmianguanwushuangguanwang', 'stafoodmianguanwushuangbeijing']
ONSTAR	['monstar', 'one star', 'onstarxitong', 'onstarshishenmeyisi', 'onstarredian', 'onstarzenmedu', 'onstarxitong xuefulan', 'konstar', 'bonstar', 'ronstar']
IBIZA	['ibizajuediqiusheng', 'ibiza xibanya', 'ibizahuya', 'ibizaweibo', 'ibizashishui', 'ibizahuyazhibo', 'ibizazhibo', 'ibizajiuba', 'ibizadianyinjie', 'ibiza dpi']
rich-healthcare	["rich-healthcarecom~911100560120yi395E'"]
didiao2	['didiao211', 'didiao2ziwangmingnv']
蟹老宋	['xielaosongfangzhuangdian', 'xielaosongxibahedian', 'xielaosonghongmiaodian', 'xielaosongcaidanjiamubiao', 'xielaosongliujiayaoqiaodian', 'xielaosongdazhaxiezenmeyang', 'xielaosongtuangou', 'xielaosongyingyeshijian', 'xielaosongsidaokoudian', 'xielaosongxianglaxiezuofa']
Jindingxuan	['jindingxuan', 'jindingxuancaidan', 'jindingxuan二gongzidafan', 'jindingxuan二gongzi', 'jindingxuanditandian', 'jindingxuancaidanjijiage', 'jindingxuanshishenmecaixi', 'jindingxuanyonghegongdiandizhi', 'jindingxuanjiameng', 'jindingxuantuanjiehudian']
BUU	['bunny', 'butter', 'buff', 'butt', 'button', 'build', 'butterfly', 'buy', 'buluofen', 'building']
jindingxuan	['jindingxuanyonghegongdiandizhi', 'jindingxuanshishenmecaixi', 'jindingxuancaidanjijiage', 'jindingxuancaidan', 'jindingxuan二gongzidafan', 'jindingxuan', 'jindingxuantuanjiehudian', 'jindingxuanjiameng', 'jindingxuanditandian', 'jindingxuan二gongzi']
xiaotudou...	['xiaotudoudezuofa', 'xiaotudouzenmezuohaochi', 'xiaotudou', 'xiaotudouxiancaidezuofa', 'xiaotudounaipingzenmeyang', 'xiaotudouzenmequpi', 'xiaotudounaiping', 'xiaotudoudezuofadaquanjiachang', 'xiaotudouweibo', 'xiaotudousidegongjujiaoshenme']
qiaowaipo	['qiaowaipo', 'qiaowaipomalaxiangguotieyingqiao', 'qiaowaipomalaxiangguo', 'qiaowaipo', 'qiaowaipomalaxiangguojiameng', 'qiaowaipomalaxiangguo', 'qiaowaiposifangcai', 'qiaowaipodongtieyingdian']
东方名剪	['dongfangmingjianbeijingfendiandizhi', 'dongfangmingjianjiagebiao', 'dongfangmingjianguanwang', 'dongfangmingjianzenmeyang', 'dongfangmingjiandianhua', 'baodingdongfangmingjian', 'dongfangmingjian tuangou', 'beijingdongfangmingjian', 'dongfangmingjianlaoban', 'dongfangmingjianchuangshiren']
Honda	['hondamotuoche', 'hondashishenmepaizi', 'honda civic', 'hondaqiche', 'honda/bentianmotuocheguanwang', 'honda jp', 'hondajiche', 'honda usa', 'honda connect']
巅峰造型	['dianfengzaoxing fangzhuangdianhua', 'dianfengzaoxingzhuanyetangrangongzuoshizenmeyang', 'dianfengzaoxinglifazhangqiudian', 'dianfengzaoxing(liujialifadian)zenmeyang', 'dianfengzaoxing(zhangzhishandian)', 'dianfengzaoxing(wusilu)zenmeyang', 'dianfengzaoxing(yuyangxilu)zenmeyang', 'dianfengzaoxing(huiquanlu)zenmeyang', 'dianfengzaoxing(jiariguangchangdian)zenmeyang']
zhengyuanyuan	['zhengyuanyuan', 'zhengyuanyuan', 'zhengyuanyuanzhuanyexiujiaofang', 'zhengyuanyuanzhuanyexiujiaofangjiameng', 'zhengyuanyuanzhuanyexiujiaodian', 'zhengyuanyuanzhihuizhijiazhenshima', 'zhengyuanyuanzhuanyexiujiaofangfujin', 'zhengyuanyuanzhuanyexiujiaofangzenmeyang', 'zhengyuanyuanxiujiaofangjiagebiaotu']
@百万庄园方庄店	['baiwanzhuangyuanfangzhuangdian']
娄三少	['lousanshaochunbing', 'lousanshaofangzhuang', 'lousanshaochunbingzenmeyang']
Green-Tree-Inn	['greentreeinnpms', 'greentreeinn.com', 'greentreeinnshijixingji', 'greentreeinnfanyi', 'greentreeinn beijing', 'greentreeinn dailan', 'greentreeinn wifimima']
xiaotudou..	['xiaotudoudezuofa', 'xiaotudouzenmezuohaochi', 'xiaotudou', 'xiaotudouxiancaidezuofa', 'xiaotudounaipingzenmeyang', 'xiaotudouzenmequpi', 'xiaotudounaiping', 'xiaotudoudezuofadaquanjiachang', 'xiaotudouweibo', 'xiaotudousidegongjujiaoshenme']
小龙坎老火锅	['xiaolongkanlaohuoguojiamengfei', 'xiaolongkanlaohuoguozenmeyang', 'xiaolongkanlaohuoguoguanwang', 'xiaolongkanlaohuoguohouchu', 'xiaolongkanlaohuoguodizhi', 'xiaolongkanlaohuoguoshijian', 'xiaolongkanlaohuoguoshiyonglaoyou', 'xiaolongkanlaohuoguodianhua', 'xiaolongkanlaohuoguo(wandadian)zenmeyang', 'xiaolongkanlaohuoguojiamengyusuan']
LAOBAOSAN	['laobaosan', 'laobaosandezuofa', 'laobaosanshishenme', 'laobaosanshihuimincaima', 'laobaosanfandiansuoyoudizhi', 'laobaosanzhengyibiaoshishenme', 'laobaosanshuanyangrou', 'laobaosan', 'laobaosandedianming', 'laobaosanhuanlegudiandianhua']
99inn	['99inn.cc']
鸿运天外天	['hongyuntianwaitiankaoyadian', 'hongyuntianwaitianwanfenglu', 'hongyuntianwaitiankaoyadiancaidan', 'hongyuntianwaitiankaoyaxikezhan', 'hongyuntianwaitiankaoyadianfengtai', 'beijingshihongyuntianwaitian', 'hongyuntianwaitianjintailudian', 'hongyuntianwaitianhetianwaitian', 'hongyuntianwaitiankaoyadian(wanfengludian)zenmeyang', 'hongyuntianwaitiankaoyadian(liujiayaodian)zenmeyang']
dawanju	['dawanju', 'dawanjueqi', 'dawanjuhongqiaodiandianhua', 'dawanju', 'dawanjia', 'dawanju', 'dawanjucheshipindaquan', 'dawanjuxiongzenmeqingxi', 'dawanjuchongwenmendian', 'dawanjudongsidian']
YLKYD	['yuanlaikeyidengdaoni', 'yulinkaoyadian', 'yinliaokeyidaishangfeijima', 'yuanlaikeyidengdaonimianfeiyuedu', 'yaoliukeyidamayaoma', 'yinliaokeyidaitiheshuima', 'yaliknyudundeguanxi', 'yiliangkeyundabaduoshaoqian', 'yilakeyouduoshaobudui', 'yulinkaoyadianyingyeshijian']
5i5j	['5i5jguanwang', '5i5jguanwangsuzhou', '5i5jsuzhou', '5i5j zhoushan', '5i5jguanwangshanghai', '爱jia5i5j']
RYB	['ranyoubao', 'ruby', 'ranyoubaozhendeyouyongma', 'rubber', 'rybd99', 'ryback', 'rybnik', 'rybyou儿yuan', 'ruyunbiandaleshishenmeqingkuang', 'renyoubeihuanlihe']
ChunBingKaoYaDian	['chunbingkaoyadian', 'chunbingkaoyadian(liujiayaoshunsantiaodian)zenmeyang', 'chunbingkaoyadian(liujiayaoshunsantiaodian)shanghugaikuang', 'chunbingkaoyadiantuijianshunsitiao', 'chunbingkaoyadiandedianhuahaoma?', 'chunbingkaoyadian(fangzhuangdian)zenmeyang']
Laochengyiguo	['laochengyiguo', 'laochengyiguoyangxiezi', 'laochengyiguo 91jm.com', 'laochengyiguoyangxiezihuoguojiamengfeiduoshao', 'laochengyiguoyangxiezi', 'laochengyiguohuoguojiamengliansuo', 'laochengyiguoyangxiezijiamengfeiduoshao', 'laochengyiguohelaochengyiguo', 'laochengyiguoyangxiezizuofa', 'laochengyiguodianhua']
ZGGJWJY	['zhongguogejuwujuyuansanji', 'zhongguogejuwujuyuanzainali', 'zhongguogejuwujuyuanwangnuo', 'zhongguogejuwujuyuanzhangshanshan', 'zhongguogejuwujuyuanpeixun', 'zhongguogejuwujuyuanmenpiao', 'zhongguogejuwujuyuanliujiatong', 'zhongguogejuwujuyuanwuxuhai', 'zhongguogejuwujuyuanba']
一麻一辣	['yimayilamalaxiangguodizhi', 'yimayilazongbu', 'yimayilamalaxiangguozongbu', 'yimayilacaidan', 'yimayilaheshenghuidian', 'yimayilaweigongcundianhua', 'yimayilamalatang', 'yimayilajiamengdianhua', 'yimayilayizhuanghualian', 'yimayilaheshenghuidiandianhua']
HaiYinHaiJi	['haiyinhaiji', 'haiyinhaijichaoshanhuoguo', 'haiyinhaijiwanda', 'haiyinhaijicaidan', 'haiyinhaijiniurouhuoguoguanwang', 'haiyinhaijihebaheli', 'haiyinhaijishiniurouhuoguo', 'haiyinhaijishangshilema', 'haiyinhaijizenmeyang', 'haiyinhaijijiamengguanwang']
Sinopec	['sinopecshishenmeyisi', 'sinopecsales.co m', 'sinopecquancheng', 'sinopecjiyou', 'sinopeczenmedu', 'sinopecshishenmegongsi', 'sinopecquanchengzenmedu', 'sinopecshishenmepaizi', 'sinopecyinbiao', 'sinopecshishenmedesuoxie']
北京何所有酒店	['beijinghesuoyoujiudiandizhi', 'beijinghesuoyoujiudianzenmeyang', 'beijinghesuoyoujiudiandianhua', 'beijinghesuoyoujiudiantupian', 'beijinghesuoyoujiudian jixing', 'beijinghesuoyoujiudianzhaopin', 'beijinghesuoyoujiudiandaobeijingnanzhandache', 'beijinghesuoyoujiudian nanzhan', 'beijinghesuoyoujiudiandaobeijingtiantanyiyuanxindangdeluxian']
dinghaishenzhen	['dinghaishenzhen', 'dinghaishenzhenshuaping', 'dinghaishenzhenqingpingzhuanyongchaochang', 'dinghaishenzhen', 'dinghaishenzhenshichengyuma', 'dinghaishenzhenbiyushenmeyisi', 'dinghaishenzhenruanjian', 'dinghaishenzhentupian', 'dinghaishenzhenqingpingzhuanyong', 'dinghaishenzhenshuapingshenqi5wanzi']
木屋烧烤	['muwushaokaochuangshiren', 'muwushaokaokeyijiamengma', 'muwushaokaocaidan', 'muwushaokaolaoban', 'beijingmuwushaokao', 'muwushaokaoyingyeshijian', 'muwushaokaojiamengfeiduoshao', 'shenzhenmuwushaokao', 'muwushaokaoguanwang', 'muwushaokaozhaopin']
洞庭鱼香	['dongtingyuxiangkechuangsanjiedianhua', 'dongtingyuxiang yizhuang', 'dongtingyuxiangcaijiacaidan', 'dongtingyuxiang liujiayao', 'dongtingyuxiang(liujiayaodian)zenmeyang', 'dongtingyuxiang(kechuangdongsanjiedian)zenmeyang', 'dongtingyuxiang(liujiayaodian)shanghugaikuang', 'dongtingyuxiang(xiangjiangbei岸dian)zenmeyang', 'dongtingyuxiang liujiayaodizhi']
fengmaokaochuan-2	['fengmaokaochuan26zhounianhuiyuanka']
涩谷造型	['seguzaoxingzenmeyang', 'yantaiseguzaoxing', 'jinanseguzaoxing']
ZGTLGJ	['zhuguantiliganjuedengji', 'zhongguotielvguojilvxingshe', 'zhongguotieluguojilianyun', 'zhuguantiliganjuedengjibiao', 'zhongguotieluguijuduoshao', 'zhaiguitieluguijuduoda', 'zhongguotielugaojijingyuan', 'zhaiguitieluguiju', 'zhongguotielugejufenbutu', 'zigongtianliguojixuexiaozhaopin']
非凡活力	['feifanhuoliyumaoqiujulebu', 'feifanhuolijiankangyouyong', 'feifanhuolijianshenrongfeng2008']
不是烧烤	['bushishaokaoxuetu', 'ribendeshaoniaoshibushishaokao', 'bushishaokao(maliandaodian)zenmeyang', 'bushishaokaoyourendezhuyaoyuanyin', 'bushishaokaolaohankoudeweidaozenmeyang', 'bushishaokaolaohankoudeweidao', 'bushishaokao(xianggangludian)zenmeyang', 'bushishaokao(datunlidian)shanghugaikuang', 'bushishaokao(dachengludian)', 'bushishaokaoba(二qiludian)zenmeyang']
柏翠酒窖	['baicuijiujiaodongshizhang', 'beijingbaicuijiujiao', 'dafangfandianbaicuijiujiao', 'baicuijiujiaoshanghugaikuang', 'baicuijiujiaoyonghupinglun']
味道工坊	['weidaogongfangtaobaomaibudaole', 'quzhouxiquweidaogongfang', 'quzhouweidaogongfang', 'weidaogongfangweishenmeguanle', 'weidaogongfangsanbeijimifanzenmeyang', 'weidaogongfangsanbeijimifan', 'weidaogongfang(xiqudian)zenmeyang', 'weidaogongfangniurouganweishenmebumaile']
hanlinkaorou	['hanlinkaorou', 'hanlinkaoroudianmendianwujiaochang', 'hanlinkaorou(wanxiangchengdian)zenmeyang', 'hanlinkaorou(babaibandian)zenmeyang', 'hanlinkaorou(shibodian)zenmeyang', 'hanlinkaorou(zhonghualudian)zenmeyang', 'hanlinkaorou(jinyingdian)zenmeyang', 'hanlinkaorou(zhengdaguangchangdian)zenmeyang', 'hanlinkaoroudianshanghugaikuang', 'hanlinkaoroulishunajiagongsi']
高兴一锅	['gaoxingyiguoxiaohuoguo', 'gaoxingyiguoshantouniurouhuoguojiameng', 'gaoxingyiguo jiamengfeiduoshao', 'gaoxingyiguoshantouniurouhuoguo', 'gaoxingyiguoweizhi', 'gaoxingyiguozenmeyang', 'gaoxingyiguoshantouniurouhuoguo(beijingdian)zenmeyang', 'gaoxingyiguochaoshanniurouhuoguozenmeyang', 'gaoxingyiguohuoguoshizhendema']
丰茂烤串2	['fengmaokaochuan26zhounianhuiyuanka']
国投商务酒店	['guotoushangwujiudianwuxianwangmima']
tangquanliangzi	['tangquanliangzi', 'tangquanliangzijiamubiao', 'tangquanliangzizenmeyang', 'tangquanliangzijiameng', 'tangquanliangzispa', 'tangquanliangzilaiguangyingdizhi', 'tangquanliangzimaliandaodianyouhui', 'tangquanliangziyongchuanyongyime', 'tangquanliangziwangjingdian']
骏怡连锁酒店	['junyiliansuojiudianjianjie', 'junyiliansuojiudiandianhua', 'junyiliansuojiudianjiage', 'junyiliansuojiudiantousudianhuaduoshao', 'junyiliansuojiudianwifimima', 'junyiliansuojiudianzongbudizhi', 'junyiliansuojiudianzenyangjiameng', 'junyiliansuojiudianlongmendian', 'lanzhoujunyiliansuojiudian', 'guangshanjunyiliansuojiudian']
zhangqiuhaitai	['zhangqiuhaitaijituanzhangjianjun', 'zhangqiuhaitai', 'zhangqiuhaitaishifucaidanjiage', 'zhangqiuhaitaixincailiaozenmeyang', 'zhangqiuhaitaifandianlaoban', 'zhangqiuhaitaifandian(xizhandian)', 'zhangqiuhaitaidajiudian', 'zhangqiuhaitaifandian-huochepiaofeijipiaodaishoudianzenmeyang', 'zhangqiuhaitaishifuzenmeyang', 'zhangqiuhaitaifandianzenmeyang']
yunhuisuo	['yunhuisuo', 'yunhuisuoshishenmedifang']
BIDR	['bidepan', 'bids', 'bidetu', 'bideluofu', 'bidedadi', 'bidelaoge', 'bidrago', 'bidras', 'baiphonedaoruhuaweishouji']
CMEC	['cmecgongsi', 'cmech', 'cmechshishenmepaiziwujin', 'cmecshiyangqima', 'cmecypt', 'cmeczongjingli', 'cmecwubu', 'cmecquancheng', 'chumo二ciyuanshaonvyouxi', 'chaomu耳caitupian']
fengmaokaochuan	['fengmaokaochuan', 'fengmaokaochuanjiameng', 'fengmaokaochuanguanwang', 'fengmaokaochuanjiamengfeiduoshaoqian', 'fengmaokaochuanzongdian', 'fengmaokaochuanquanguofendiandizhi', 'fengmaokaochuanjinquanguangchangdian', 'fengmaokaochuansongjiangdian', 'fengmaokaochuanzhichunludiandianhua', 'fengmaokaochuanbeijingjigedian']
bulaoxilaocaiguan	['bulaoxilaocaiguan(rongfengdian)zenmeyang']
spzp	['shangpinzhaipei', 'shangpinzhaipeizenmeyang', 'shangpinzhaipeiguanfangwang', 'shangpinzhaipeigupiao', 'shipinzhaopianhechengruanjian', 'shangpinzhaipeiquanwudingzhi', 'shangpinzhaipei', 'shangpinzhaipeisuofeiyaneigehao', 'shangpinzhaipeijiajujiagebiao', 'shengpizipinyin']
京味斋	['jingweizhaikaoyadianzenmeyang', 'jingweizhaijingsongdian', 'jingweizhaidianhua', 'jingweizhaiyayuncunniaochaodian', 'jingweizhaiyuetandiandianhua', 'jingweizhaicaidan', 'jingweizhaikaoyadian', 'jingweizhaizenmeyang', 'jingweizhaidizhi', 'jingweizhaibeiwaludiandianhua']
podinns	['podinnswuxianwangmima', 'podinnsshishenmeyisi']
-xizhanshangyeguangchang	['xizhanshangyeguangchangzenmeyang']
匆匆那年	['congcongnaniangeci', 'congcongnaniandianshiju', 'congcongnanianxiaoshuo', 'congcongnanianjieju', 'congcongnanianjianpu', 'congcongnanianjitapu', 'congcongnaniandianyingguankan', 'congcongnaniangequ', 'congcongnanianhaojiubujian', 'congcongnaniantaiju']
CHAOZHOUHUI	['chaozhouhui', 'chaozhouhuiqiaodajiudian', 'chaozhouhuiqiaodajiudianchehuo', 'chaozhouhuiguan', 'chaozhouhuiqiaodajiudianchehuo', 'chaozhouhuiqiaodajiudianshigu', 'chaozhouhuicaidan', 'chaozhouhuiqiaochehuo', 'chaozhouhuilinwanjiagufen']
NOVOTEL	['novoteljiudianjixing', 'novoteljiudian', 'novotelshishenmeyisi', 'novotelbeijing', 'novotelshou尔', 'novotelxianggang', 'novoteltaiguo', 'novotelbeijingwangfujing', 'novotelshanghaiatlantis', 'novoteljiudianwifimima']
siyeniula	['siyeniula', 'siyeniula dongshizhang', 'siyeniulashiqingzhendema', 'siyeniulachuangshiren', 'siyeniulawuqilong']
hehuatai	['hehuataicaicanting', 'hehuataicaidazhongdianping', 'hehuataideng', 'hehuataijishan', 'hehuataicaiguomaodian', 'hehuatai', 'hehuataiyang', 'hehuataimianshejijieshuo', 'hehuataicaicantingzenmeyang', 'hehuataiyaohuibuhuiliuchan']
jiangtaiwuer	['jiangtaiwu二jiamengfei', 'jiangtaiwu二', 'jiangtaiwu二shenmeyisi', 'jiangtaiwu二caidanjiamubiao', 'jiangtaiwu二shizizhuma', 'jiangtaiwu二baike', 'jiangtaiwu二beijingdian', 'jiangtaiwu二tuangoudazhongdianping', 'jiangtaiwu二caidan', 'jiangtaiwu二shenmedangci']
-华纺酒店-	['zhengyiluhuafangjiudian']
戈拿旺巴西烤肉	['genawangbaxikaorouzizhucan', 'genawangbaxikaoroucaishikoudian', 'genawangbaxikaoroutuangou', 'genawangbaxikaoroubiaoyan', 'genawangbaxikaorouguanwang', 'genawangbaxikaorouyayuncun', 'beijinggenawangbaxikaorou', 'genawangbaxikaorou(yayuncunzhiyingdian)zenmeyang', 'genawangbaxikaorou(chongwenmendian)', 'genawangbaxikaorou(yayuncunzhiyingdian)']
hankoujietou	['hankoujietou', 'hankoujietou taiyanggong', 'hankoujietouchongwenmen', 'hankoujietou dazhongdianping', 'hankoujietou guoruichengdian', 'hankoujietou canguan', 'hankoujietoufabijiaohao', 'hankoujietoufaduoshaoqian']
DingJunHui	['dingjunhui', 'dingjunhuizuixinbisaixiaoxi', 'dingjunhui147', 'dingjunhui2019zuixinbisai', 'dingjunhuishijiepaiming', 'dingjunhuinaliren', 'dingjunhuipaimingshijiedijiming']
华纺酒店	['zhengyiluhuafangjiudian']
Super8	['super8jiudian', 'super8jiaojuan', 'super8mm', 'super8youxi', 'super888bbb', 'super8sheyingji', 'super8jiudianguanwang', 'sikedasuper8', 'kedasuper8']
mingshiguang	['mingshiguang', 'mingshiguangyankeyiyuan', 'mingshiguangyankeyiyuanhaobuhao', 'mingshiguangyankeyiyuandizhi', 'mingshiguangdianhua', 'mingshiguangyankejiage', 'mingshiguanghuan', 'mingshiguangyiyuan', 'mingshiguangguazhouyuehua', 'mingshiguangxipingnanfengshuiliuti']
yunhaiyao	['yunhaiyaoqiguoji', 'yunhaiyaoguanwang', 'yunhaiyaotesecaibidiancai', 'yunhaiyaocaidan', 'yunhaiyaojiameng', 'yunhaiyaoyunnancai', 'yunhaiyaobeijingyouduoshaojiadian', 'yunhaiyao', 'yunhaiyao', 'yunhaiyaochuangshiren']
huachengshishang	['huachengshishangjiudiandizhi', 'huachengshishangjiudian', 'huachengshishangjiudianzenmeyang', 'huachengshishangjiudian(beijingchongwenmenditiezhandian)zenmeyang', 'huachengshishangzizhuhuoguochengzenmeyang', 'huachengshishangjiudianwanshangjidianguanmen', 'huachengshishangjiudianqinglvfangduoshaoqian', 'huachengshishangfushiguangchangzenmeyang', 'huachengshishangjiudianbeijingzhanchongwenmendian', 'huachengshishangjiudianbeijingchongwenmendian']
rongchengguli	['rongchengguli']
便宜坊哈德门店	['pianyifanghademendianditu', 'pianyifanghademendiantuangou', 'pianyifanghademendiandianhua', 'pianyifanghademendiantesecai', 'pianyifanghademendianxuyaopaiduibu', 'pianyifanghademendiandizhi', 'pianyifanghademendianditie', 'pianyifanghademendianyingyeshijian', 'pianyifanghademendianrenjunxiaofei', 'pianyifanghademendiantingchechang']
DBS	['dongbeishifandaxuerenwenxueyuan', 'duanbeishan', 'dbshishenmeyisi', 'dbsshoushu', 'dibaishineigeguojia', 'dongbeishifandaxue', '阿sidunmadingdbs', 'dongbeisansheng', 'dongbeishiyoudaxue', 'dengbishulieqiuhegongshi']
BlueNote	['blue note beijing', 'blue note jazz club', 'blue note shanghai', 'blue note beijingguanwang', 'blue notesxiangshui', 'blue notesxiangshuiduoshaoqian', 'blue note china', 'blue note lizongsheng', 'blue noteyanchubiao', 'blue noteshishenmeyisi']
wendingfu	['wendingfu', 'wendingfujintushuguan', 'wendingfuli', 'wendingfudaoxuexiao', 'wendingfuqianmen23haojianjie', 'wendingfuzenmechuli', 'wendingfuguqiji']
fenglianbinguan	['fenglianbinguan']
HuoLuHuo	['huoluhuojiamengfei', 'huoluhuoniangaohuoguojiamengfeiduoshao', 'huoluhuozizhu', 'huoluhuonanguazhoudezuofa', 'huoluhuocaidan', 'huoluhuozizhushisuibiandianma', 'huoluhuonianshenme', 'huoluhuozizhuduoshaoqian', 'huoluhuo', 'huoluhuokaorou']
BYBO	['bybon', 'baibokouqiang', 'byboywudao', 'baibokouqiangyiyuan', 'baibokouqiangyiyuanzenmeyang', 'baibokouqiangxiyajiage', 'baibozhengxing', 'baibokouqiangbayaduoshaoqian', 'baibokouqiangdizhi']
ciming	['ciming', 'cimingtijian', 'cimingtijianzhongxin', 'ciming', 'cimingtijiandianhua', 'cimingtijianguanwang', 'cimingtijianbaogao', 'ciming', 'cimingtijianzenmeyang', 'cimingtijianzhongxindianhua']
思妍丽	['siyanlimeirongyuan', 'siyanliguanwang', 'siyanlijianshen', 'siyanlimianmo', 'siyanlizhaopin', 'siyanlichanpinjiameng', 'siyanlijiameng', 'siyanlijiamengfei', 'siyanliqudouyin', 'siyanli shougou']
tangchaoktv	['tangchaoktv', 'tangchaoktv', 'tangchaoktvjiage', 'tangchaoktvtuangou', 'tangchaoktvdianhua', 'tangchaoktvzhongguancundian', 'tangchaoktvjiaodadonglu', 'wandatangchaoktv', 'songxiantangchaoktv', 'tangshanwandaguangchangtangchaoktv']
岩之畔	['yanzhipanyiliaomeirongjigou', 'yanzhipanluoshen', 'beijinglimeikangyanzhipan', 'yuyanzhipan', 'duyilirenyuyanzhipan']
徽风阁	['jiaodadonglushangyoujiahuifengge']
YMSQ	['yuanmaishanqiu', 'yanmeishiqiumei', 'yimashiqihuachang', 'yemeishequ', 'yimashiqihuachangbaozha', 'yanmeishiqiumei儿chifanshipin', 'yanmeishiqiumeimeishishipin', 'yemaishuqian', 'yemaishuqianzuijiandandezuofa', 'yanmeishiqiumeiweibo']
北京市党派团体办公楼	['beijingshidangpaituantibangongloufuwuguanlizhongxin']
MeiNianDaJianKang	['meiniandajiankangtijianzhongxinzenmeyang', 'meiniandajiankangguanwang', 'meiniandajiankanggupiao', 'meiniandajiankangtijianzhongxin', 'meiniandajiankangdianhua', 'meiniandajiankangtijianzhongxindianhua', 'meiniandajiankangtijianzhongxinbaogaochaxunapp', 'meiniandajiankangtijianzhongxinguanwangchakanbaogao', 'meiniandajiankangtijiankexinma', 'meiniandajiankang']
juelvbang	['juelvbanglvhuo', 'juelvbangdaobilema']
lashangyin	['lashangyin', 'lashangyinkaoyu', 'lashangyindaili', 'lashangyinmalaxiangguojiamengfeiduoshao', 'lashangyinxiaochi', 'lashangyinmalaxiangguozenmeyang', 'lashangyingyu', 'lashangyinkaoyucaidanjiamubiao', 'lashangyinggaikanshenmeke', 'lashangyinmudanyuandianhua']
五台云	['wutaiyunyangshengsushiguan', 'wutaiyunhaimeichangzhaogongma', 'wutaiyunyizhan', 'wutaiyunqiyedaxue', 'wutaiyunhaidajiudianlaoban']
川成元	['chuanchengyuan malaxiangguo', 'chuanchengyuanshaloushishenmeyisi', 'chuanchengyuan malaxiangguodiliao', 'chuanchengyuanmalaxiangguozuofa', 'chuanchengyuanmalaxiangguocaidan', 'beijingchuanchengyuan', 'chuanchengyuanmalaxiangguodizhi', 'chuanchengyuanmalaxiangguo(jianwaidian)zenmeyang', 'chuanchengyuanmalaxiangguo(xizhimendian)zenmeyang']
川渝小馆	['chuanyuxiaoguan(beidajiedian)zenmeyang', 'chuanyuxiaoguan(beidajiedian)', 'chuanyuxiaoguan(yinhesohodian)zenmeyang', 'chuanyuxiaoguan(pingyangludian)zenmeyang', 'chuanyuxiaoguandianhuamingguangqiaobeidajie', 'chuanyuxiaoguan(qijiahuozijie)zenmeyang', 'chuanyuxiaoguandianhuamingguangqiao']
nongtangli	['longtangli', 'longtanglibanmutoudexiehouyu', 'hangzhoulongtangli', 'longtanglijiameng', 'longtanglibanmutouxiayiju', 'longtanglibidiancai', 'longtanglipaomaxiehouyu', 'longtanglicanting', 'longtanglicaidan', 'longtanglidizhi']
CECEP	['cecep zhongguojieneng', 'cecepshishenmeyisi', 'cecepei偶heshichuxian', 'cecepailuanqizuizhunque', 'ci二chune2piandichishenmeyao', 'ci二chunestrdlpiangao']
Tai_Shu_Xi	['taishuxijiachangcai', 'taishuxinideguanhuai fenbukai', 'taishuxijiachangcaidianhua', 'taishuxilezhongmepo', 'taishuxinideguanhuai', 'taishuxijiachangcaihuixindian', 'taishuxihuanningshuma', 'taishuxiderennengtanlian爱ma', 'taishuxinideguanhuaishenmege', 'taishuxiyou安men']
yunledi	['yunledisiyinghui', 'yunledisiyinghuifenglanguoji', 'yunledisirenyingyuan', 'yunledisiyinghuiduoshaoqian', 'yunledi shexiangtou']
shuimumicheng	['shuimumichengmishitaotuo', 'shuimumichengmishitaotuogonglve', 'shuimumichengmishitaotuozenmeyang', 'shuimumichengmishitaotuo(zhongguancunqijiandian)zenmeyang', 'shuimumichengmishitaotuo(sijiqingdian)zenmeyang', 'shuimumichenglangrenshazhuoyouVRyouxiguanzenmeyang', 'shuimumichengzhenrenmishitaotuozenmeyang', 'shuimumichengmishitaotuo(mingguangqiaodian)zenmeyang', 'shuimumichengmishitaotuo(dayuechengnandian)zenmeyang', 'shuimumichengmishitaotuoda案']
Sizzler	['sizzlercanting', 'sizzler zhixiangchishala']
xizhimenbinguan	['xizhimenbinguandianhua', 'xizhimenbinguanbuduiwaiyingye', 'xizhimenbinguandizhi', 'xizhimenbinguanyuding', 'xizhimenbinguanduoshaoqian', 'xizhimenbinguanguanfangwangzhan', 'xizhimenbinguandao301yiyuan', 'xizhimenbinguanfujinditiezhan', 'xizhimenbinguanshenmejibie', 'xizhimenbinguanfujindefandian']
ROUCHUANWANGZONGDIAN	['rouchuanwangzongdianzenmeyang']
tangchaoKTV	['tangchaoktv', 'tangchaoktv', 'tangchaoktvjiage', 'tangchaoktvtuangou', 'tangchaoktvdianhua', 'tangchaoktvzhongguancundian', 'tangchaoktvjiaodadonglu', 'wandatangchaoktv', 'songxiantangchaoktv', 'tangshanwandaguangchangtangchaoktv']
BJSFRBG	['beijingshifengruibinguan']
汤城小厨	['tangchengxiaochucaidanjijiagebiao', 'tangchengxiaochuguanwang', 'tangchengxiaochucaidan', 'tangchengxiaochuzenmeyang', 'tangchengxiaochujinbaojiediandianhua', 'tangchengxiaochu jinbaojie', 'tangchengxiaochuzhongguancundian', 'tangchengxiaochuciyunsidiandianhua', 'tangchengxiaochufangzhuangdiandianhua', 'tangchengxiaochuqixiapinpai']
tpyzq	['taipingyangzhengquanguba', 'taipingyangzhengquanguanwang', 'taipingyangzhengquanappxiazai', 'taipingyangzhengquangufenyouxiangongsi', 'taipingyangzhengquandianhua', 'taipingyangzhengquan', 'taipingyangzhengquangupiao', 'taipingyangzhengquanjiaoyiruanjian', 'taipingyangzhengquanjintianshishenmejiawei', 'taipingyangzhengquan xinlang']
bianjinggongheguo	['bianjinggongheguo(huijugouwuzhongxin)zenmeyang', 'bianjinggongheguocantingyunhaiyao', 'bianjinggongheguodongnanyaxiaochilianmengzenmeyang', 'bianjinggongheguo(huijugouwuzhongxin)', 'bianjinggongheguo(meiluochengdian)zenmeyang', 'bianjinggongheguotianjindayuecheng', 'bianjinggongheguocantingzenmeyang']
BNU	['bnuz', 'bnuzjiaowu', 'bnuzjiaowu jiaowuguanlixitong', 'bu二', 'bnudaxue', 'bnubao', 'bnugg', 'bnuzwangluojiaoxuezonghepingtai', 'bnubaobaoshishenmepaizi', 'bnuzjiaowuchu']
tingyun	['tingyun', 'tingyunxuan', 'tingyun', 'tingyun', 'tingyun霭霭 shiyumengmeng', 'tingyun', 'tingyunbingxudezuozheshi', 'tingyun霭霭', 'tingyunlieche', 'tingyun taoyuanming']
CUPONE	['cuponekafeiwangjing']
yuxueyuan	['yuxueyuan', 'yuxueyuanappxiazai', 'yuxueyuanhuiyuanzhidema', 'yuxueyuanzhensuo', 'yuxueyuandianhua', 'yuxueyuanwenjiyiwen', 'yuxueyuanzenmeshanchuduotianjiadebaobao', 'yuxueyuandedongxizhengpinma', 'yuxueyuanmianmoduoshaoqianyihe', 'yuxueyuanguanwang']
CCB	['ccbleijiangyayao', 'ccbjianrongjiayuan', 'ccbd', 'ccbshishenmeyinhang', 'ccbc', 'cencibuqi', 'cengchubuqiong', 'ccbp', 'ccbshishenmeyisi', 'chaocibaidicaiyunjian']
huashangjiudian	['huashangjiudian', 'huashangjiudiandizhi', 'huashangjiudianguanliyouxiangongsi', 'huashangjiudianktvyoumeinvma', 'huashangjiudianqiantaidianhuahaoma', 'huashangjiudian(xiamenwandian)zenmeyang', 'huashangjiudian-zhongcantingzenmeyang', 'huashangjiudian(ganhedadao)zenmeyang', 'huashangjiudian-KTVzenmeyang']
眉州小吃	['meizhouxiaochizhaopinxinxi', 'meizhouxiaochicaidan', 'meizhouxiaochishangjiediandianhua', 'meizhouxiaochidianhua', 'meizhouxiaochishinalidetese', 'meizhouxiaochihemeizhoudongpo', 'meizhouxiaochi jisiliangmian', 'meizhouxiaochishinalidexiaochi', 'meizhouxiaochicaidantujijiage', 'meizhouxiaochijiamengfeiduoshao']
天和晟国展店	['tianheshengguozhandianzhaopian']
beifangyouyicun	['beifangyouyicunyingyeshijian', 'beifangyouyicunshanghugaikuang', 'beifangyouyicunfarenshishui', 'beifangyouyicunzaixiancaidan']
suzumei	['suzumeibeijing', 'suzumeiguozhanzheng']
秘宅	['mizhaijuyuan', 'mizhaipeixunlei', 'mizhaigeshengrou limengjiao', 'mizhaimadian', 'mizhaigetingzainali']
@张亮麻辣烫	['zhangliangmalatangshishuikaide', 'zhangliangmalatangjiameng', 'zhangliangmalatangjiamengfeiyong', 'zhangliangmalatangjiamengfeiyongxuyaoduoshaoqian', 'zhangliangmalatangchuangshirenheyangguofu', 'zhangliangmalatangguanwang', 'zhangliangmalatanglaobanjiaoshenme', 'zhangliangmalatangbaidubaike', 'zhangliangmalatangheyangguofuneigehaochi', 'zhangliangmalatangshenmegeng']
dizhibinguan	['dizhibinguan', 'dizhibinguanzuojilugongjiao', 'dizhibinguancanting', 'dizhibinguan-cantingzenmeyang', 'dizhibinguan(hongxingxiang)', 'dizhibinguan(xingshenglu)zenmeyang', 'dizhibinguan(lizhoudongluyiduan)zenmeyang', 'dizhibinguan(lianchenglu)zenmeyang', 'dizhibinguancantingzenmezuoche', 'dizhibinguanzuojilugongjiaoche']
黎明园宾馆	['beijinglimingyuanbinguan']
迪亚天天	['diyatiantianchaoshi', 'diyatiantianyingyeshijian', 'diyatiantianguanwang', 'diyatiantianhuiyuanka', 'diyatiantianjiameng', 'diyatiantianjiamengfei', 'diyatiantianapp', 'diyatiantianmendian', 'diyatiantianhuiyuan', 'diyatiantian suning']
meishenxuqing	['meishenxuqing', 'meishenxuqingyiliaomeirong', 'meishenxuqingmeilamenzhen', 'meishenxuqingsanyuanqiao', 'meishenxuqingzenmeyang', 'meishenxuqingmeilamenzhendizhi', 'meishenxuqingmeilamenzhenpian', 'meishenxuqingshengwujiaonianhe', 'meishenxuqingjiehunlema']
nadu	['nadu', 'naduohua', 'naduo', 'nadu', 'nadu', 'nadumalaxiangguo', 'nadoubushiguo', 'nadushishenmezhiwei', 'naduni', 'naduyin']
Ibis	['ibisjiudian', 'ibisjiudianshijixingji', 'ibismoxing', 'ibises', 'ibiszenmedu', 'ibishun', 'ibis budget', 'ibis xiangji', 'ibis hotel beijing', 'ibisco']
xibeihanzi	['xibeihanzidexinggetedian', 'xibeihanzicanting', 'xibeihanzicantingtibeidian', 'xibeihanzizigequ', 'xibeihanzi haotian yisou', 'xibeihanzihunshenjirou', 'xibeihanzidebaimagua', 'xibeihanzishishenmeyangzide', 'xibeihanzidianhuajingwangdianhua', 'xibeihanzicha']
helijia	['helijia', 'helijiaguanwang', 'helijiakefudianhua', 'helijiazenmeyang', 'helijiameijiashizhenshishouru', 'helijiazhaopin', 'helijiaxinshounengjiedaodanma', 'helijiadexianzhuang', 'helijianfeifangfa', 'helijiaappxiazai']
huajiayiyuan	['huajiayiyuancaidan', 'huajiayiyuanrongkedian', 'huajiayiyuanqinghuaxiludian', 'huajiayiyuanyuanmingyuandian', 'huajiayiyuandongzhimendian', 'huajiayiyuanjinrongjiedian', 'huajiayiyuanqinghuaxilu', 'huajiayiyuansiheyuan', 'huajiayiyuan', 'huajiayiyuanhuixindian']
Bluche	['blucher', 'bluchepaibaise']
ccb	['ccbleijiangyayao', 'ccbjianrongjiayuan', 'ccbd', 'ccbshishenmeyinhang', 'ccbc', 'cencibuqi', 'cengchubuqiong', 'ccbp', 'ccbshishenmeyisi', 'chaocibaidicaiyunjian']
Homeinns	['homeinnshenmeyisi']
wennuandelvtu	['wennuandelvtuzuowen', 'wennuandelvtuzuowen500zi', 'wennuandelvtu700zizuowen', 'wennuandelvtuzuowenkaitou', 'wennuandelvtuxiezuosilu', 'wennuandelvtuzuowenliubaizi', 'wennuandelvtuzuowen400zi', 'wennuandelvtu800zizuowen', 'wennuandelvtuzuowen700']
lanhuhui	['lanhuhui', 'lanhuhuivipgongguan', 'lanhuhuivipgongguan guanmen', 'lanhuhuivipgongguan 2000duo', 'lanhuhui jing安']
wanglaoliu	['wanglaoliu', 'wanglaoliutieguodunyu', 'wanglaoliuzenmebugengxinle', 'wanglaoliushuochanggeci', 'wanglaoliudeshuochangbgm', 'wanglaoliudajieshangshoulounenmo', 'wanglaoliutieguodunyuchuangshiren', 'wanglaoliujisuanjishuochang', 'wanglaoliudajielounenmo', 'wanglaoliudetaobaodianjiaoshenme']
shikongtang	['shikongtangjituan']
salahuaer	['salahua儿', 'salahua儿xiyumeishi', 'salahua儿shishenmeyisi', 'salahua儿chuangshiren', 'salahua儿xiyumeishicaidan', 'salahua儿zhige', 'salahua儿taiyanggongdianhua']
beiwaiqingshao	['beiwaiqingshao', 'beiwaiqingshaoyingyu', 'beiwaiqingshaoyingyuxiaoqu', 'beiwaiqingshaoyingyuxiaoqudianhua', 'beiwaiqingshaoxiaoqu', 'beiwaiqingshaoyingyuapp安zhuo', 'beiwaiqingshaoguanwang', 'beiwaiqingshaoyingyupeixunzhongxinzenmeyang', 'beiwaiqingshaoyingyuguanwangpingtai', 'beiwaiqingshaoyingyufeiyong']
RBT	['rbt214', 'ribentianhuang', 'ribentianqi', 'rebatiaowushipin', 'rbtc', 'rbtshenmeyisi', 'rbt219', 'ribenren', 'ribentianqiyubao', 'rbtzhengshu']
muwushaokao	['muwushaokaochuangshiren', 'muwushaokaokeyijiamengma', 'muwushaokaocaidan', 'muwushaokaolaoban', 'muwushaokaoyingyeshijian', 'muwushaokaojiamengfeiduoshao', 'muwushaokao', 'muwushaokaojidianhaixianbanjia', 'muwushaokaodian', 'muwushaokaoguanwang']
menggongfang	['menggongfangkafeiba', 'menggongfangapp', 'menggongfangyingcheng', 'menggongfangkafei', 'menggongfangkafeiyouxiangongsi', 'menggongfangkafeiyingyeshijian', 'menggongfangjishu', 'menggongfangnvpukafeiwuzhaomu', 'menggongfangyingchengzaixiamennali']
saboten	['sabotenghu', 'sabotenghushipin']
CFLD	['chenfaladegerenziliao', 'chanfuladuzikeyiweimuruma', 'chanfuladuzizenmeban', 'chifenglidehaochu', 'cfldeng', 'cfldshenmeyisi', 'cfpfuliduoshaofenguo', 'caifanglaodangyuanxinde', 'cefenlobduanfa']
qiaobamei	['qiaobameichuanchuan', 'qiaobameijia', 'qiaobameidaimaozitupian', 'qiaobameikaoyujiamengdian', 'qiaobamei安zhendiandianhua', 'qiaobameishuzuopin', 'qiaobameichuanchuanjiameng', 'qiaobameichuanchuanzenmeyang', 'qiaobameiyoubaga', 'qiaobameiyoumaozitupian']
@机场巴士	['jichangbashishikebiao', 'jichangbashizenmemaipiao', 'jichangbashi1haoxian', 'jichangbashi2haoxian', 'jichangbashi2haoxianshikebiao', 'jichangbashizenmechengzuo', 'jichangbashizhejiangyinyuexueyuanxianshijianbiao', 'jichangbashichangpingxianshikebiao', 'jichangbashishanxilishibowuguanxianshikebiao', 'jichangbashiduoshaoqian']
华洋菜市场	['beijingyayuncunhuayangcaishichang']
shenmimei	['shenmimeirongyuanmanhuaquanjizaixianguankan', 'shenmimeigui奥xiukecheng', 'shenmimeishaobuhaoremianfei', 'shenmimeifashalong2', 'shenmimeirenyudianyingmianfeiban', 'shenmimeirongyuan dianying', 'shenmimeiyiliaomeirong', 'shenmimeiguijingxin2019', 'shenmimeinvzuiqiangbao安luxuan', 'shenmimeishaonianzhuanxiaoshengyanyuan']
chanzuimao	['chanzuimao', 'chanzuimaojiameng', 'chanzuimaotupian', 'chanzuimaochuanchuanxiang', 'chanzuimaochuanba', 'chanzuimaojiameng,zongbuzainali', 'chanzuimaokaoroubanfan', 'chanzuimaologo', 'chanzuimaoshenmeyisi', 'chanzuimaozenmeyang']
HOSA	['hosanna', 'hosan', 'hosashishenmepaizi', 'hosane', 'hosannashishenmeyisi', 'hosamalaixiya', 'hosam', 'hosazhubao', 'hosana', 'hosagu']
lanzhoulamian	['lanzhoulamian', 'lanzhoulamiandezuofa', 'lanzhoulamianshineigeminzu', 'lanzhoulamiancaidan', 'lanzhoulamiantangliaopeifangdan', 'lanzhoulamianreliang', 'lanzhoulamiantupian', 'lanzhoulamianpaihangbang', 'lanzhoulamianshinalirenkaide', 'lanzhoulamiannajiazuihaochi']
yuzhiguang	['yuzhiguang', 'yuzhiguangzhengxingmeirong', 'yuzhiguang', 'yuzhiguangzhengxingmeirongzhengguima', 'yuzhiguang', 'yuzhiguang', 'yuzhiguangyiliaomeirongyiyuan', 'yuzhiguangliuzhongguo', 'yuzhiguangzhengxingmeirongdianhua', 'yuzhiguang']
城市之光	['chengshizhiguangloupan', 'chengshizhiguangdongwang', 'chengshizhiguangzhuobielin', 'chengshizhiguangdianying', 'xinlizuizhichengshizhiguang', 'chengshizhiguangdouban', 'wankechengshizhiguang', 'chengshizhiguangjieju', 'chengshizhiguangxiangyan', 'chengshizhiguangxiangyanjiage']
xespy	['xue而sipeiyou', 'xue而sipeiyouhexue而sidequbie', 'xue而sipeiyou minxue qinxue', 'xue而sipanyushiqiaojiaoxuedian', 'xue而sipeiyoushishenmeyisi', 'xue而sipeiyoupanyuxiaoqu', 'xue而sipeiyoumijixilie', 'xue而sipeiyouhehaoweilai', 'xue而sipeiyouxiaoshan', 'xue而sipeiyouwifimima']
nanmensijishuanrou	['nanmensijishuanrou', 'nanmensijishuanrouzenmeyang', 'nanmensijishuanrouzuojiazhuangdian', 'nanmensijishuanrouyayuncundian', 'nanmensijishuanrou(shaoyaojubeilidian)zenmeyang', 'nanmensijishuanrou(wukesongdian)zenmeyang', 'nanmensijishuanrou(yayuncundian)shanghugaikuang', 'nanmensijishuanrou(lishuiqiaodian)', 'nanmensijishuanrou(shaoyaojubeilidian)', 'nanmensijishuanrou nanmenshuanrou']
五指生	['wuzhishengzuliao', 'wuzhishengguanwang', 'wuzhishengzuliaobaojianjiamubiao', 'wuzhishengzuliaozhengguima', 'jinchengwuzhisheng', 'wuzhishengyayuncundian', 'wuzhishengjiamengxuyaoduoshaoqian', 'wuzhishengxiao', 'wuzhishengxiaoshizhinajixiao', 'wuzhishengspa']
chuanshifengge	['chuanshifenggezhuangxiuxiaoguotu', 'chuanshifenggenongcunzijianfang', 'chuanshifenggeshishenmeyisi']
HUAZHU-Hanting.	['huazhuhantingjiudianwifimima', 'huazhuhanting', 'huazhuhantingguanwang', 'huazhuhantingjiudian', 'huazhuhantingningbo', 'huazhuhantingjiudianshujuxielou', 'huazhuhantingshangwangdengludizhi', 'huazhuhantingshizhi', 'huazhuhantingkefudianhua', 'huazhuhantingwifidengluyemian']
小南国	['xiaonanguohuayuanjiudian', 'xiaonanguocaidanjiamubiao', 'shanghaixiaonanguo', 'xiaonanguofandian', 'xiaonanguodianhuadingcandianhua', 'guilinxiaonanguo', 'xiaonanguolaoban', 'xiaonanguotesecai', 'xiaonanguozhaopin', 'xiaonanguogujia']
hongxizu	['hongxizu', 'hongxizuyangshenghuiguan', 'hongxizuyangshenghuiguanpaomeizi', 'hongxizuoyong', 'hongxizuzhengguima', 'hongxizuoyongyuanli', 'hongxizuobianqi', 'hongxizuchunxiuludiandianhua', 'hongxizumajiabaodian', 'hongxizuobianqidehuiqikong']
大亨小厨	['dahengxiaochudingcandianhua', 'dahengxiaochujutidizhi', 'dahengxiaochushanghugaikuang', 'dahengxiaochuyonghupinglun']
tuojiangxiaozhen	['tuojiangxiaozhen', 'tuojiangxiaozhenduiwaijingmaodaxue', 'tuojiangxiaozhencanyinguanliyouxiangongsi', 'tuojiangxiaozhen(安zhendian)shanghugaikuang']
动感易带网吧	['dongganyidaiwangbazenmeyang']
sinopec	['sinopecshishenmeyisi', 'sinopecsales.co m', 'sinopecquancheng', 'sinopecjiyou', 'sinopeczenmedu', 'sinopecshishenmegongsi', 'sinopecquanchengzenmedu', 'sinopecshishenmepaizi', 'sinopecyinbiao', 'sinopecshishenmedesuoxie']
伊藤洋华堂亚运村店	['yitengyanghuatangyayuncundiantuihuanhuo', 'yitengyanghuatangyayuncundiandianhua']
Yitel	['yitelong', 'yiteluliya', 'yitelongtupian', 'yitelaken', 'yitelonghebawanglong', 'yiteliudianhanji', 'yitelongjianbihua', 'yitelongvsbawanglong', 'yitelongchishenmesiliao', 'yitelaiquanwudingzhi']
Atour	['atour jiudian', 'atourshenmeyisi', 'atourzenmedu', 'atour shenyang', 'atourjiudianwifimima', 'atourshishenmepaizi', 'atours', 'atourjiudianwuxianmima', 'gratour', 'wtatour']
CKI	['ckin', 'ckit', 'ckin2u', 'climb', 'ckitjiyinjiancedeyiyi', 'ckin2uxiangshuijiage', 'click15', 'ckiqiuheicong0daok']
城市之光3	['chengshizhiguang360pxiazai xiazai']
bengeshousi	['bengeshousi', 'bengeshousi beijing', 'xi安bengeshousi']
bibichi	['bibichichuanbazenmeyang', 'bibichijihaihaowandeyouxi']
@茶花妹子过桥米线	['beijingchahuameiziguoqiaomixian', 'chahuameiziguoqiaomixian', 'chahuameiziguoqiaomixianzenmeyang', 'chahuameiziguoqiaomixiandi安men1dianzenmeyang', 'chahuameiziguoqiaomixian(di安men1dian)zenmeyang', 'chahuameiziguoqiaomixian beijing']
五指生亚运村店	['wuzhishengyayuncundianxiujiaoshi', 'wuzhishengyayuncundiandianhua', 'wuzhishengyayuncundiantupian', 'wuzhishengyayuncundianjiamubiao', 'wuzhishengyayuncundian zhaozongjian', 'wuzhishengyayuncundiannvjishi', 'wuzhishengyayuncundianzhaopin']
dechuanjia	['dechuanjia', 'dechuanjiakang', 'dechuanjiaguang', 'dechuanjiamao', 'dechuanjiakangrenwuguanxitu', 'dechuanjiazu', 'dechuanjiakangmingyan', 'dechuanjiakangquanjizaixianyuedu', 'dechuanjiagang', 'dechuanjiada']
diguashequ	['diguashequ', 'diguashequdeyunyingmoshi', 'diguashequyinglimoshi', 'diguashequxianzaizenmeyangle']
交通银行信用卡	['jiaotongyinhangxinyongkadianhua', 'jiaotongyinhangxinyongkazhongxin', 'jiaotongyinhangxinyongkadianhuarengongfuwurexian', 'jiaotongyinhangxinyongkajifenduihuanshangcheng', 'jiaotongyinhangxinyongkazhongxindianhua', 'jiaotongyinhangxinyongkakefudianhuarengongfuwu', 'jiaotongyinhangxinyongkajifenzenmeduihuan', 'jiaotongyinhangxinyongkadianhuahao', 'jiaotongyinhangxinyongkazenmezhuxiao', 'jiaotongyinhangxinyongkamaidanbaappxiazai']
shigehuntun	['shigehuntundereliang', 'shigehuntundereliangduoshao']
mengjizhoupu	['mengjizhoupu', 'mengjizhoupu(xiaoyingdian)zenmeyang', 'mengjizhoupuyayuncundian', 'mengjizhoupu(dongxiaokoudian)zenmeyang', 'mengjizhoupu(dongxiaokouzhendian)zenmeyang', 'mengjizhoupu(huilongguandongdajiedian)zenmeyang', 'mengjizhoupu(lishuiqiaodian)zenmeyang', 'mengjizhoupu(tiantongyuandian)zenmeyang', 'mengjizhoupu(lishuiqiaodian)']
zhangliangmalatang	['zhangliangmalatang', 'zhangliangmalatangshishuikaide', 'zhangliangmalatangjiameng', 'zhangliangmalatangjiamengfeiyong', 'zhangliangmalatangjiamengfeiyongxuyaoduoshaoqian', 'zhangliangmalatangchuangshirenheyangguofu', 'zhangliangmalatangguanwang', 'zhangliangmalatanglaobanjiaoshenme', 'zhangliangmalatangreliang', 'zhangliangmalatangtangdi']
三泉冷面	['sanquanlengmianwangjingdian', 'sanquanlengmianzaibeijingjijiadian', 'sanquanlengmian jiameng', 'sanquanlengmianjianjie', 'sanquanlengmianguanwang', 'sanquanlengmianwangjiaodianweizhi', 'sanquanlengmianlaoban', 'sanquanlengmianjiamengliucheng', 'sanquanlengmianyuyue', 'yanjiaosanquanlengmian']
zixiamen	['zixiamen', 'zixiamen wangjing', 'zixiamenhanguoliaolizenmeyang', 'zixiamenghuanfeixianguanwang', 'zixiamen dazhongdianpingtuangou', 'zixiamenhanguoliaoliwangjingdian', 'zixiamenkaoroudianzenmeyang']
Barsak	['baraka', 'barsake']
zhangshifu	['zhangshifu', 'zhangshifucuipiwuhuarou', 'zhangshifujiagongyipilingjian,diyitianwancheng', 'zhangshifukaihuochequachengsonghuo', 'zhangshifu', 'zhangshifukaichequachengsonghuo', 'zhangshifuchuchengbatianxiawanzheng', 'zhangshifu', 'zhangshifubianhaoyigezhongguojiexuyao3fenzhong']
kaximu	['kaximu', 'kaximoduo', 'kaximugang', 'kaximudianzhan', 'kaximujujiqiang', 'kaximuchaojijujibuqiang', 'kaximuhanguo', 'kaximumenglong', 'kaximuyulouzenmeyang', 'kaximugangranmeidianchang']
裕食坊私家湘菜	['yushifangsijiaxiangcaizenmeyang', 'yushifangsijiaxiangcaibaolidian']
MAZHA-JIUWU	['mazhajiuwu']
RYSWJD	['raryasuowenjiandaozuixiao', 'raryasuowenjiandabukai', 'ruiyashangwujiudiandianhua', 'rongyuanshangwujiudian', 'riyushangwujiedaiyongyu', 'rongyushiwujiade']
延世医疗	['yanshiyiliaomeirongzenmeyang', 'yanshiyiliaozhengxingmeirong', 'yanshiyiliaoyanjingshibai', 'yanshiyiliaomeirong案li']
huohuozhuti	['huohuozhutijiameng']
lazhuang	['lazhuang', 'lazhuanghuoguo', 'lazhuangshibaobei尔kaidema', 'lazhuangjiamengfei', 'lazhuanghuoguoshibaobei尔deme', 'lazhuanghuoguodianjiamengfeiduoshao', 'lazhuanghuoguodianjiameng', 'lazhuangjiamengfeiduoshao', 'lazhuangchongqinglaohuoguojiamengfeiduoshao', 'lazhuangyabaoganjun']
Tianfujiachangcai	['tianfujiachangcaicanguanzenmeyang', 'tianfujiachangcaiguan(furongxiangdian)zenmeyang', 'tianfujiachangcaiguanzhou·shuijiaochengzenmeyang']
maxen	['maxence', 'maxene', 'maxend', 'maxencefaguonanmo', 'maxenceziliao', 'maxencenvpengyou', 'maxenceheaxel', 'maxencebaidubaike', 'maxencegerenziliao', 'maxencefudimo']
JinYongKTV	['jinyongktv', 'jinyongktvbengdi']
熔时FIRESIDE	['rongshifiresidelaobanshishui', 'rongshifiresidepingjia', 'rongshifiresidejiameng', 'rongshifiresidelaoban', 'rongshifiresideguanwang', 'rongshifiresideliansuo']
lvhezi	['lvhezi', 'lvhezibao', 'lvhezibaozhenjia', 'lvhezibaozenmedakai', 'lvheziyuanneigehaoyong', 'lvhezibaojiage', 'lvhezibaoshishenmeshihouchude', 'lvhezihunheshishenmeyanse', 'lvhezidegongxiao']
TanTanDaLu	['tantandalu', 'tantandaluwudaokou', 'tantandalujiameng', 'tantandaluzhongliangxiangyun', 'tantandaluzenmeyang', 'tantandaluwangjingdian', 'tantandaluyouhuiquan']
parisbaguette	['parisbaguettejiamu', 'parisbaguettezenmeyang', 'parisbaguette balibeitianyuebing', 'parisbaguetteguanwang', 'parisbaguettedangao', 'parisbaguettezhongguoguanwang']
CupOne	['cuponekafeiwangjing']
美都波	['meidoubokaorou', 'meidoubohanguokaorou jiameng', 'meidoubobaihuo', 'meidoubokaorouwukesongdian', 'wangjingmeidoubo']
四季民福wifi	['sijiminfuwifimima']
Wanrongxiaochu	['wanrongxiaochu', 'wanrongxiaochuwangjingdian', 'wanrongxiaochuzhongyangmeishijiemu', 'wanrongxiaochulaobanxingwanma']
yiruntang	['yiruntangwangjingdian', 'yiruntangdaxiyangxinchengdian', 'yiruntangwangfujing', 'yiruntangguofeng', 'yiruntangyinlingguoji dianhua', 'yiruntangyinlingguojidian', 'yiruntangzenmeyang', 'yiruntangshizuoshenmede', 'yiruntangwangjingdianjiagebiao']
剪艺人生－中福	['jianyirenshengzhongfudiandianhua', 'jianyirenshengzhongfubaihuodian']
huangtucheng	['huangtucheng', 'huangtuchengyu', 'huangtuchengyu', 'huangtuchengfen', 'huangtuchengyin', 'huangtucheng', 'huangtuchengyinshuo', 'huangtuchengdaoyanqing', 'huangtuchengdaogubeikou', 'huangtuchengyuyouneixie']
hongjingyu	['hongjingyu', 'hongjingyuyin', 'hongjingyuan', 'hongjingyuanyamaziyouzhiliangzenmeyang', 'hongjingyuan', 'hongjingyuyuan', 'hongjingyuyinbao', 'hongjingyuyinzaixianting', 'hongjingyuyinfanyi', 'hongjingyuanyamaziyou']
yesido	['yesidofanyizhongwen', 'yesidozhongwenshishenmeyisi', 'yesidoyedaozaoxing', 'yesidoshenmeyisi', 'yesidogecishishenmeyisi', 'yesidozenmedu', 'yesidoshishenmege', 'yesidofanyishishenme', 'yesidochenqiao恩gequ', 'mowenweiyesido']
辉佐参鸡汤	['huizuocanjitangdongshizhang', 'huizuocanjitangjiamengfeiduoshao', 'huizuocanjitang(liangmaqiaodian)zenmeyang', 'huizuocanjitang(zhaoyangdayuechengdian)zenmeyang', 'huizuocanjitangwangjingdianzenmeyang', 'huizuocanjitangjiamengdianhua', 'huizuocanjitangheshenghuidian', 'huizuocanjitang(wangfujingdian)', 'huizuocanjitang(dayuechengdian)shanghugaikuang', 'huizuocanjitang dazhongdianping']
HanTing	['hanting', 'hantingjiudian', 'hantingjiudianguanwang', 'hantingqu', 'hanting', 'hantingdianhua', 'hantingjiudiandianhua', 'hantinghuiyuan', 'hantingjiudiandianhua400', 'hantingyoujiajiudian']
寂寞的豆芽	['jimodedouyashaokaodian', 'jimodedouyajiamengfeiduoshao', 'jimodedouyacaidan', 'jimodedouyaguanwang', 'jimodedouyajiamengfeiguima', 'jimodedouyahuiyuanrijihao', 'jimodedouyachuangshiren', 'jimodedouyazongdiandizhi', 'jimodedouyashiyangqiaodian', 'lidazuicanyinjimodedouya']
yixuanjiaozi	['yixuanjiaoziguan', 'yixuanjiaozi', 'yixuanjiaoziguanbeixiaohe', 'yixuanjiaoziguan(lidudian)', 'yixuanjiaoziguan(guangshundian)', 'yixuanjiaoziguan(beixiaohegongyuandian)', 'yixuanjiaoziguanzenmeyang', 'yixuanjiaoziguanbeixiaohe,dianhua']
Baihualin	['baihualin', 'baihualingeci', 'baihualinxi', 'baihualinmingtian', 'baihualinju', 'baihualinjitapu', 'baihualinyinyuejie', 'baihualinjian', 'baihualinjingqu', 'baihualintupian']
@辉佐参鸡汤	['huizuocanjitang', 'huizuocanjitangdongshizhang', 'huizuocanjitangjiamengfeiduoshao', 'huizuocanjitang(liangmaqiaodian)zenmeyang', 'huizuocanjitang(zhaoyangdayuechengdian)zenmeyang', 'huizuocanjitangwangjingdianzenmeyang', 'huizuocanjitangjiamengdianhua', 'huizuocanjitangheshenghuidian', 'huizuocanjitang(wangfujingdian)', 'huizuocanjitang(dayuechengdian)shanghugaikuang']
喜来稀肉	['xilaixirouguanwang', 'xilaixiroucaidan', 'xilaixiroujiamengfeiduoshao', 'xilaixirouzenmechi', 'xilaixirou taiyangdehouyi', 'xilaixiroucaidanjiage', 'xilaixiroushenzhendianzainali', 'xilaixirou tuichu ha尔bin', 'xilaixirougaoxinwangzuodian', 'xilaixirouhanjiediandianhua']
火齐潮汕砂锅粥	['huoqichaoshanshaguozhoucaidan', 'wudaokouhuoqichaoshanshaguozhou', 'huangdaohuoqichaoshanshaguozhou', 'huoqichaoshanshaguozhouzenmeyang', 'huoqichaoshanshaguozhou(guomaodian)zenmeyang', 'huoqichaoshanshaguozhou(muxiyuandian)zenmeyang', 'huoqichaoshanshaguozhou(heshenghuidian)zenmeyang', 'huoqichaoshanshaguozhoujiamubiao', 'huoqichaoshanshaguozhou(taiyanggongkaidedian)zenmeyang', 'huoqichaoshanshaguozhoujiamengfei']
sijiminfu	['sijiminfu', 'sijiminfukaoyadian', 'sijiminfugugongdian', 'sijiminfukaoya', 'sijiminfukaoyadianyuyue', 'sijiminfucaidan', 'sijiminfukaoyaduoqianyizhi', 'sijiminfukaoyadianbidiancai', 'sijiminfukaoyadiangugongdian', 'sijiminfucaidanjiagebiao']
金万享	['jinwanxiangguojishangwujiudian', 'jinwanxiangxiyudazhongdianping', 'beijingjinwanxiang', 'wangjingjinwanxiang']
xiaoshiguangmang	['xiaoshiguangmang', 'xiaoshiguangmanggonglve', 'xiaoshiguangmangzenmecainenglianji', 'xiaoshiguangmangnandugaihuiputong', 'xiaoshiguangmangzenmerengbianpao', 'xiaoshiguangmangfuhenu', 'xiaoshiguangmangsuidaorukou', 'xiaoshiguangmangwan偶', 'xiaoshiguangmangwangluohaishidanji', 'xiaoshiguangmanghuangjinwuqitujian']
黄门老灶火锅	['huangmenlaozaohuoguoguanfangwangzhan', 'huangmenlaozaohuoguolaobanshishui', 'huangmenlaozaohuoguoshinalide', 'huangmenlaozaohuoguohongmiaodian', 'huangmenlaozaohuoguolaobanxupeng', 'handanhuangmenlaozaohuoguo', 'linyihuangmenlaozaohuoguo', 'wuhannanhuhuangmenlaozaohuoguo', 'huairouwandahuangmenlaozaohuoguo', 'fangzhuanghuangmenlaozaohuoguo']
新天地KTV	['xintiandiktvdianhua', 'xintiandiktvjiage恩shi', 'shaoyangsuhexintiandiktv', 'xiaojiangxintiandiktv', 'jiangxiaxintiandiktv', 'wanzhouxintiandiktv', 'bazhouxintiandiktv', 'puchengxianzuanshixintiandiktv']
duolezhiri	['duolezhiri', 'duolezhiriguanwang', 'duolezhiridangao', 'duolezhirijiamengfeiduoshaoqian', 'duolezhiridangaojiagebiao', 'duolezhiridangaodinggou', 'duolezhirizhaopin', 'duolezhirimianbao', 'duolezhirimendian', 'duolezhirishinalidepinpai']
虎千代	['huqiandaijujiuwu']
剪艺人生-夏都	['jianyirenshengxiadoumeirong']
MrPIZZA	['mrpizzashishenmepinpai', 'mrpizzaguanwang', 'mrpizzahebishengke', 'mrpizzashinalide', 'mrpizzacaidanjijiage', 'mrpizzahaochima', 'mrpizzajiamengfeiduoshaoqian']
kangyunyangsheng	['kangyunyangshengtang', 'kangyunyangshenghuiguan', 'kangyunyangshenghuiguanzhengguima', 'kangyunyangshengzudaozenmeyang', 'kangyunyangshenghuiguan pinglun', 'kangyunyangshenghuiguanshilihedian', 'kangyunyangshenghuiguan sanyuanqiao']
逅客民宿	['houkeminsuzenmeyang', 'houkeminsuguanwang', 'houkeminsukefudianhua']
一个叫川的地方	['yigejiaochuandedifangnanchang', 'yigejiaochuandedifangbeijing', 'yigejiaochuandedifangshuikaide', 'yigejiaochuandedifangcanting', 'yigejiaochuandedifang gaikuang', 'yigejiaochuandedifang68zhehuodongzenmesuande', 'yigejiaochuandedifangnanchangqijiandianzenmeyang']
路边烤牛肉	['wangjing24xiaoshilubiankaoniurou', 'beijingwangjinglubiankaoniurou', 'beijing24xiaoshilubiankaoniurou', 'lubiankaoniurou(wangjingdian)', 'lubiankaoniurou.chuangshizenmeyang', 'lubiankaoniurou(wangjingdian)shanghugaikuang', 'lubiankaoniurou(gongtizongdian)zenmeyang', 'lubiankaoniuroushilihedian', 'lubiankaoniurou.chuangshi(haidiandian)zenmeyang', 'lubiankaoniurou.chuangshi(haidiandian)']
huohuozhuti2	['huohuozhuti2haodianzenmeyang']
zhuluchalou	['zhuluchalou', 'zhuluchalouxueyuanludian', 'zhuluchalouxizhimendian', 'zhuluchalouzhichunludian', 'zhuluchalouwangjing', 'zhuluchaloumingguangqiaodian', 'zhuluchaloululiudaokou']
TOMNTOMSCOFFEE	['tomntomscoffeezhongwenjiaoshenme', 'tomntomscoffee(longhushidaitianjiedian)zenmeyang']
