tingyun	['婷婷', 'sting', '听书', '听说', '听雪楼', '停电', '停止编号', '听海', '听风者', '听妈妈的话']
meishenxuqing5G	['美神煦氰医疗美容', '美神煦氰', '美神煦氰美啦门诊', '美神煦氰整形', '美神煦氰美啦门诊地址', '美神煦氰美啦门诊骗', '美神煦氰生物胶粘合', '美神煦氰結婚了嗎', '美神煦氰双眼皮价格']
yuxueyuan	['育学园', '余学友', '育学园诊所', '俞学友', '与雪有关的诗句', '育学园app下载', '雨靴英语', '寓学于乐', '寓学于乐的意思是什么', '浴血羊山电影']
huashangjiudian	['华商酒店', '华商酒店管理有限公司', '华商酒店招聘信息', '华商酒店 自助餐', '华商酒店(厦门湾店)怎么样', '华商酒店-中餐厅怎么样', '华商酒店电话漳州', '华商酒店(淦河大道)怎么样', '华商酒店-KTV怎么样']
HUAZHU-OrangeHotel	['huazhuorangehotel']
京客隆微信支付	['京客隆微信公众号']
wujiekongjian-SYQ	['無界空间招聘什么岗位']
CUPONE-2	['coupon的汉语意思', 'cupone', 'coupon rate', 'coupon怎么读音', 'coupon的意思', 'coupon 翻译', 'coupon是什么意思中文翻译', 'cupon是什么意思', '醋泼尼龙松副作用', 'coupons怎么读音发音']
Orange-Hotel	['orange后面加es还是s']
bjfyxybg	['北京法院信息网审判', '兵甲富于胸中', '北京飞跃鞋实体店地址', '北京风雅小筑日本料理', '北京阜阳心血管病医院', '搬家非要选日子吗', '北京凤仪轩', '宝鸡方言闲转记歌词', '北京法院悬赏公告', '北京府右小学在哪里']
beifangyouyicun	['北方有隐翅虫吗', '北方有萤火虫吗', '北方有一鱼名为鲲', '北方有一点点奶茶吗', '北方有一个海南', '北方有伊人在水一方', '北方有一佳人 诗', '北方有一口井封印', '北方又一村电话', '北方又一村怎么样']
suzumei	['suzuki', '宿醉', 'suzuki摩托车', '诉组词', '俗组词', '宿醉2', '赎罪', '宿醉3', 'suzuki是什么牌子', 'suzumu']
suning-free	['肃宁房价2019最新房价', '苏宁返利平台叫什么', '肃宁房价', '苏宁服务电话', '苏宁分期付款流程', '苏宁分期', '苏宁返利', '苏宁分期付款买手机', '苏宁服务市场', '肃宁房屋出售最新信息']
CUPONE-1	['coupon的汉语意思', 'cupone', 'coupon rate', 'coupon怎么读音', 'coupon的意思', 'coupon 翻译', 'coupon是什么意思中文翻译', 'cupon是什么意思', '醋泼尼龙松副作用', 'coupons怎么读音发音']
hmvkafe	['海马v70空调格在哪里']
dizhibinguan	['低脂饼干有哪些', '低脂饼干', '低脂冰淇淋', '帝之冰魂资源', '低脂饼干的做法', '地质宾馆', '帝智冰箱怎么使用开关', '低脂饼干热量', '低致病性禽流感的治疗', '地质宾馆电话']
HUAZHU_Ibis	['花坠成语', '花锥', '滑椎', '花追肥用什么肥料', '滑坠钓法', '滑坠', '花缀的意思是什么', '花追叶棍型研究', '花追寻凋零']
HomeInns	['homeinn', 'homie', 'homeie是什么意思', 'homeinn什么意思', '红霉素', 'homeis', 'homein', 'homeic', 'homeins', '红玫瑰']
helijia-bj	['河狸家', '河狸家官网', '河狸家美甲师真实收入', '河狸家客服电话', '河狸家怎么样', '河狸家客服', '赫里将军', '河狸家新手能接到单吗', '河狸家的现状', '合理减肥法']
HaiDiLaoDianCai	['海底捞店', '海底捞电话', '海底捞电话预约', '海底捞点菜攻略', '海底捞店长收入', '海底捞店长助理的要求', '海底捞店长杨丽娟事件', '海底捞点菜攻略2人', '海底捞电话订餐', '海底捞店助']
Bankcomm	['bankcomm.com', 'bankck', 'bank code什么意思', 'bank充电宝']
wanglibank	['网利宝', '王力宏', '网利宝最新消息', '王立波', '王立彬', '王林', '王琳凯', '王琳', '王丽波', '网利宝交流群']
meishenxuqing	['美神煦氰医疗美容', '美神煦氰', '美神煦氰美啦门诊', '美神煦氰整形']
xibeihanzi	['西北航空', '西北航空大学', '西贝海鲜', '西北汉子', '西北汉子的性格特点', '西北航天航空大学', '西北航空公司', '西北行攻略', '西贝海鲜汇', '西贝海鲜汇槐安路店']
helijia	['合力', 'helicopter', '何立峰', '赫莲娜', '鹤立鸡群', 'helio', 'helios', 'helium', '合力泰', '河流']
huajiayiyuan	['花家怡园', '花家怡园四合院', '花家怡园菜单', '花家怡园东直门店', '花家怡园圆明园店', '花家怡园惠新店', '花家怡园融科店', '花家怡园金融街店', '花家怡园清华西路店', '花家怡园四季青店']
Homeinns	['homeinn', 'homie', 'homeie是什么意思', 'homeinn什么意思', '红霉素', 'homeis', 'homein', 'homeic', 'homeins', '红玫瑰']
wennuandelvtu	['温暖的旅程作文600字', '温暖的旅程', '温暖的李免费漫画', '温暖的李', '温暖的旅程作文500字', '温暖的旅程800字', '温暖的旅程作文800字', '温暖的李漫画百度网盘', '温暖的旅行600字作文', '温暖的离别']
24小时自助图书馆	['24小时自助图书馆', '24小时自助银行', '24小时自助银行可以办卡吗', '24小时自助下单平台', '24小时自助银行可以存钱吗', '24小时自助洗车', '24小时自助图书馆书籍多吗', '24小时自助便利店', '24小时自助法院', '24小时自助图书馆怎么使用']
lanhuhui	['蓝湖', '兰花', '兰花草', '兰花指', '蓝狐', '兰花蟹', '蓝环章鱼', '蓝灰色', '蓝琥珀柯北辰', '蓝胡子']
HaiDiLaoHuoGuo	['海底捞火锅', '海底捞火锅加盟', '海底捞火锅价格表', '海底捞火锅底料', '海底捞火锅加盟费多少', '海底捞火锅成立时间', '海底捞火锅学生证69折时间', '海底捞火锅怎么样', '海底捞火锅蘸料怎么配', '海底捞火锅图片高清']
wanglaoliu	['王老吉', '王老菊', '王老板', '王老五', '王老师', '王老吉吉悠', '王老六', '王老吉和加多宝是怎么回事', '王老虎抢亲', '王老七']
Starbucks	['starbur中文什么意思', 'starbur', 'starbucks', '星巴克', 'star布鞋', 'starbus是什么意思', 'starbur是什么意思', 'starbux', 'starbug', 'starbur什么品牌']
shikongtang	['时空偷渡少女', '时空特战队', '是空调费电还是风扇费电', '时空特警满座衣冠胜雪', '时空偷渡之洪荒 小说', '时空头号玩家', '时空特警', '时空泰运回馈', '时空偷猎者txt下载']
salahuaer	['撒拉花儿西域美食', '撒拉花儿', '撒拉花儿是什么意思', '萨拉花西坝河店', '撒拉话翻译', '萨拉花饭店', '撒拉花是什么意思', '撒拉话是什么话', '撒拉花儿太阳宫电话']
siyeniula	['四爷您又被套路了', '四爷牛拉', '四爷你被套路', '思也念卿', '肆野宁洛云', '四爷年妃', '四爷牛拉总店在哪', '四爷牛拉创始人', '撕夜聂小雨', '四爷牛拉 董事长']
beiwaiqingshao	['北外青少', '北外青少英语', '北外青少英语校区', '北外青少英语校区电话', '北外青少校区', '北外青少官网', '北外青少英语培训中心怎么样', '北外青少英语app安卓', '北外青少英语官网平台', '北外青少英语费用']
SunnyDental	['sunny的男朋友']
MeiNianDaJianKang	['美年大健康', '美年大健康体检中心官网查看报告', '美年大健康体检中心', '美年大健康体检中心报告查询app', '美年大健康体检可信吗', '美年大健康体检中心电话', '美年大健康体检中心怎么样', '美年大健康招聘', '美年大健康体检套餐', '美年大健康体检中心客服电话']
muwushaokao	['木屋烧烤', '木屋烧烤创始人', '木屋烧烤加盟费多少', '木屋烧烤官网', '木屋烧烤菜单', '木屋烧烤营业时间', '木屋烧烤老板', '木屋烧烤店', '木屋烧烤几点海鲜半价']
4008190099	['4008190099', '4008190488', '4008190518', '4008190770443', '4008190909', '4008190988', '4008190186']
menggongfang	['梦工坊', '梦工坊咖啡吧', '梦工坊影城', '梦工坊app', '勐拱翡翠官网', '梦工坊咖啡', '勐拱翡翠', '梦工坊影城蔡塘', '梦工坊青年', '梦工坊技术']
saboten	['萨博', 'sabotage', '萨博尼斯', 'sabon', '萨博汽车', 'saboteur', 'sabor', '萨博班', '萨博95']
Pandabrew	['盼达不退押金', '盼达不退押金怎么处理', 'pandas', 'panda包', 'panda包包官网', '盼达北碚网点', '盼达爆胎', '潘达蹦床主题公园门票', '盼达不退钱咋办', 'panda冰箱怎么样']
OrangeHotel	['orange后面加es还是s']
PizzaHut	['pizza怎么读音发音', 'pizza hut', 'pizza什么意思', 'pizza怎么读', 'pizza做法', 'pizza游戏', '披萨怎么做', 'pizzaisa', 'pizza币', 'pizza可数吗']
