中国联通-鹿港小镇	['中国联通路由器登陆用户名密码', '中国联通路由器设置', '中国联通路由器', '中国联通路由器los亮红灯', '中国联通路由器信号灯', '中国联通逻辑id和密码都是什么']
LunYuCunZhuang.	['轮雨村庄', '轮雨村庄之禁忌游戏', '轮雨村庄(天鹅湾店)怎么样']
AppleStore	['app了store', 'app了store无法连接怎么办', 'app了store无法登录', 'app了store验证码老是白的', 'app了store是什么意思', 'apple store怎么改成中文', 'apple store无法连接', 'apple store无法下载', 'apple store自动扣费', 'app了store打不开']
ChateauStarRiver	['chateaustarriver.com']
QianZiLian-2	['千子莲足道', '千子莲足道有飞机吗', '千子莲', '嵌字联', '嵌字联生成器', '千子莲养生会所燕郊', '千字两百是什么意思', '签字两个字怎么写', '浅紫连衣裙搭配什么包']
qlhk2014	['全力火开2开放城市']
homeinns3	['homeinn', 'homeinn什么意思', 'homeins']
Bankcomm	['bankcomm.com', 'bankck', 'bank code什么意思', 'bank充电宝']
QJD1864	['清洁度111会变严重', '清洁度1到2是什么意思', '清洁度1v正常吗', '请记得1998', '清洁度1234度怎么写的', '千斤顶150吨什么价', '欠京东1500京东要起诉', '缺角的100元可以用吗', '清洁度123哪个严重', '清洁度11度什么意思']
homeinns2	['homeinn', 'homeinn什么意思', 'homeins']
TangGong	['唐国强', '糖果', '塘沽天气', '塘沽', '唐功红', '唐高宗', '唐古拉山', '堂哥', '糖果英文']
chaoyangjianshen	['朝阳建设集团有限公司', '朝阳建设银行', '朝阳健身房月卡价格表', '潮阳建设银行电话', '朝阳健身房', '朝阳建设', '朝阳建市时间', '朝阳建三线是哪到哪', '朝阳健身操第十二套', '朝阳建设银行三燕支行']
jazz.ya	['jazz是什么舞种', 'jazz是什么意思中文翻译', 'jazz舞', 'jazz funk是什么舞种', 'jazzcat舞蹈考级视频', 'jazz rap', 'jazz怎么读', 'jazz分类']
caffebene	['caffe编译matlab接口']
眉州东坡-12	['眉州东坡酒楼', '眉州东坡菜单', '眉州东坡酒楼电话', '眉州东坡集团', '眉州东坡网上订餐', '眉州东坡酒楼菜单', '眉州东坡电话', '眉州东坡官网', '眉州东坡小吃', '眉州东坡门头沟']
CMCC-WEB	['cmcc是什么网络', 'cmcc的wifi密码是多少', 'cmcc-s1', 'cmcc-tv', 'cmccweb是什么网络', 'cmcc-xj', 'cmccedu登陆界面网址', 'cmcc是什么网络收费吗', 'cmcc通用密码']
CU_ziroom	['粗孜然的用法', '醋渍如何清洗']
qianzilianzudao	['千子莲足道', '千子莲足道有飞机吗', '千子莲足道消费价格', '千子莲足浴价格表', '千子莲足道怎么样', '千姿莲足道', '千子莲足疗店', '千子莲足疗会所怎么样', '千子莲足道(金牛街荷塘月色店)怎么样', '千子莲足道(亦庄分店)怎么样']
HUAZHU-Hanting	['华住汉庭酒店wifi密码', '华住汉庭', '华住汉庭酒店', '华住汉庭官网', '华住汉庭宁波', '华住汉庭酒店数据泄漏', '华住汉庭wifi密码', '华住汉庭优惠券', '华住汉庭投诉电话', '华住汉庭电话是多少']
56033657	['560338624042683044', '02131356033', '076982256033', '江诗丹顿756033']
Sephora-Guest	['sephora广州店', 'sephora广州哪里有卖', 'sephora官网电话', 'sephora贵吗']
7daysInn	['7days游戏攻略', '7days to die', '7days结局', '7days面膜', '7days下载', '7days歌曲', '7days游戏', '7days攻略', '7days什么意思']
misshuo	['mission', 'missing', 'miss是什么意思', 'miss you', 'missed', 'missile', 'miss a', 'missing operate system', 'miss you是什么意思', 'miss sixty是什么牌子']
tianehui	['天鹅', '天鹅湖', '天鹅臂', '天鹅堡', '天鹅蛋', '天鹅绒', '天阿降临', '天鹅颈', '天鹅座流星雨', '天鹅简笔画']
LiJiaJia-wifi	['李佳佳微博', '李嘉佳微博']
24小时自助图书馆	['24小时自助图书馆', '24小时自助银行', '24小时自助银行可以办卡吗', '24小时自助下单平台', '24小时自助银行可以存钱吗', '24小时自助洗车', '24小时自助图书馆书籍多吗', '24小时自助便利店', '24小时自助法院', '24小时自助图书馆怎么使用']
红银河wifi	['红银河网吧电话']
JuZiShu_QNL	['桔子树', '桔子树怎么养', '桔子树小说', '桔子树培训中心', '橘子树', '桔子水晶酒店', '橘子树怎么养', '桔子树叶子发黄的原因', '橘子树图片', '橘子树怎么修剪']
chongqingxiaomian	['重庆小面', '重庆小面的做法', '重庆小面加盟店', '重庆小面的做法及配料', '重庆小面图片', '重庆小面培训哪家最好', '重庆小面加盟费多少钱', '重庆小面加盟要多少钱']
jinshoushao	['金手勺', '金寿山', '金首饰', '金首饰怎么清洗才亮', '金首饰价格', '金首饰回收', '金首饰哪个牌子好', '金手勺东北菜', '金寿什么字']
shishangmatou	['时尚买手', '时尚码头', '时尚买手是什么职业', '时尚马尾辫的扎法图片', '时尚码头全国连锁店', '时尚妈妈产后修复加盟', '时尚买手怎么入行', '时尚码头美容美发', '时尚码头北京连锁店']
LunYuCunZhuang2	['轮雨村庄', '轮雨村庄之禁忌游戏', '轮雨村庄(天鹅湾店)怎么样']
MeowCafe	['meow长板', 'meowcon美瞳官网', 'meowcat', 'meow长板到底有多软', 'meow长板是专业板吗', 'meow长板好不好', 'meow长板是专业版吗']
QianZiLian-1	['千子莲足道', '千子莲足道有飞机吗', '千子莲', '嵌字联', '嵌字联生成器', '千子莲养生会所燕郊', '千字两百是什么意思', '签字两个字怎么写', '浅紫连衣裙搭配什么包']
PizzaHut	['pizza怎么读音发音', 'pizza hut', 'pizza什么意思', 'pizza怎么读', 'pizza做法', 'pizza游戏', '披萨怎么做', 'pizzaisa', 'pizza币', 'pizza可数吗']
LunYuCunZhuang3	['轮雨村庄', '轮雨村庄之禁忌游戏', '轮雨村庄(天鹅湾店)怎么样']
.@博成雅居酒楼	['博成雅居酒楼', '博成雅居青年路']
PUPPY_TOWN	['puppy特殊含义', 'puppy图片', 'puppy投影仪官网']
huaniucanguan	['花牛餐馆']
runjiangnan2	['润江南朝阳大悦城店', '润江南', '润江南旅行社', '润江南旅行社怎么样', '润江南 订餐 电话', '润江南倒闭', '润江南热水器', '润江南热水器怎么安装', '润江南餐厅怎么样']
LianJia	['梁舜燕病逝', '联合早报', '梁博', '链家', '连云港', '梁家辉', '梁朝伟', '联通', '梁舜燕几岁', '李安']
Starbucks	['starbur中文什么意思', 'starbur', 'starbucks', '星巴克', 'star布鞋', 'starbus是什么意思', 'starbur是什么意思', 'starbux', 'starbug', 'starbur什么品牌']
bianlifeng	['便利蜂', '便利蜂加盟费多少', '便利蜂官网', '便利蜂招聘', '便利蜂咖啡', '便利蜂工资怎么那么高', '便利蜂连锁便利店', '便利蜂加盟', '便利蜂加盟费', '便利蜂app']
weishiguang	['胃食管反流', '胃食管反流病的症状', '胃食管反流吃什么药', '胃食管反流病怎么治', '为时过早', '胃食管反流怎么冶', '胃食管反流病能治好吗', '胃食管反流病的症状吃什么药', '胃食管反流的治疗', '胃食管反流病能活多久']
Waipojia	['外婆', '外婆家', '外婆菜', '外婆的澎湖湾', '外婆的家', '外婆桥', '外婆周杰伦', '外婆歌词', '外婆英文', '外婆的澎湖湾歌词']
ICBC-WiFi	['icbc网络金融部刘曼', 'icbc网络金融部事件', 'icbc网络金融部八卦', 'icbc温哥华', 'icbc网络金融部员工', 'icbc网讯', 'icbc微信聊天水木', 'icbc网上银行客户端', 'icbc微信刘曼']
BJLYFCYY	['北京淋浴房', '北京旅游服务公司', '北京莱茵服装旗舰店', '补救淋浴房积水的垫子', '北京旅游防晒必备', '北京淋浴房维修电话', '北京六院附近如家', '北京梨园附近商场', '保加利亚房产投资', '北京刘逸夫']
runjiangnan	['润江一号', '润江昆仑府', '润江集团', '润建股份', '润江煦园', '润建股份有限公司', '润江新华壹号院', '润江壹号 开发区', '润江地产石家庄', '润江花苑']
CGB-WIFI	['参观博物馆的观后感', '村干部违法举报信样本', '参观博物馆作文', '参观博物馆', '晨光本味修正带怎么修', '参观博物馆观后', '参观博物馆的心德体会', '参观博物馆的活动成果', '村干部为村民干的好事', '彩钢板屋顶防水价格']
DiaoYeniunan	['雕爷牛腩', '雕爷牛腩失败的原因', '雕爷牛腩创始人', '雕爷牛腩现状', '雕爷牛腩菜单价目表', '雕爷牛业外卖包装', '雕爷牛腩现状2019', '雕爷牛腩创始人陈小春', '雕爷牛腩筷子', '雕爷牛腩外卖图片']
xianaohui	['仙傲', '虾脑', '腺癌', '西安奥特莱斯', '西安奥体中心', '西安奥特莱斯折扣店在哪', '仙傲全文免费阅读', '虾脑可以吃吗', '西安奥体中心在什么地方', '西安奥特莱斯哪家好']
YAN-BOOKS	['严伯钧', '烟波浩渺', '烟波江上使人愁', '烟波浩渺什么意思', '烟波江上使人愁的前一句是什么', '淹脖子', '研钵', '烟波钓叟歌', '岩博酒业', '眼波横by困倚危楼']
BEERALL	['beer是什么意思中文', 'beer怎么读', '贝尔', 'beers', 'bear', 'beer是什么意思', 'bees', 'beef', 'beer pong', 'beer可数吗']
homeinns	['homeinn', 'homie', 'homeie是什么意思', 'homeinn什么意思', '红霉素', 'homeis', 'homein', 'homeic', 'homeins', '红玫瑰']
XuePankaochuan	['薛蟠烤串', '薛蟠烤串 张艺兴', '薛蟠烤串为什么叫薛蟠', '薛蟠烤串老板是谁', '薛蟠烤串官网']
yingpaisijianshen	['英派斯健身', '英派斯健身年卡价格表', '英派斯健身器材', '英派斯健身俱乐部', '英派斯健身价格', '英派斯健身电话', '英派斯健身怎么样', '英派斯健身器材价格', '英派斯健身官网', '英派斯健身年卡多少钱']
xiaojungan	['肖俊', '小军鼓', '小君', '小郡肝', '萧军', '肖军', '小郡肝是什么', '萧敬腾', '小君舞蹈秀', '小欢喜']
