qiaobamei	['乔巴', '乔宝儿君之牧免费阅读', '乔巴图片', '乔巴山', '侨胞', '翘班', '乔巴头像', '乔宝宝', '乔巴加点', '乔帮主']
黑土印象大厅1	['黑土印象凯旋城店', '黑土印象三元桥店', '黑土印象三元桥', '黑土印象亚运村店电话', '黑土印象(亚运村店)怎么样', '黑土印象(万科红店)怎么样', '黑土印象风味餐厅怎么样', '黑土印象(三元桥店)', '黑土印象亚运村店关闭']
Bankcomm	['bankcomm.com', 'bankck', 'bank code什么意思', 'bank充电宝']
TangGong	['唐国强', '糖果', '塘沽天气', '塘沽', '唐功红', '唐高宗', '唐古拉山', '堂哥', '糖果英文']
shenmimei	['恐怖复苏', '神秘客', '神秘老公惹不起', '神秘海域', '神秘博士', '神秘老公有点坏', '神秘果', '神秘巨星', '神秘爹地惹不起', '神秘岛']
HUAZHU-OrangeHotel	['huazhuorangehotel']
chanzuimao	['馋嘴', '馋嘴牛蛙', '馋嘴蛙', '馋嘴叶', '馋嘴王小闹', '馋嘴猫', '馋嘴鸭', '馋嘴公主', '馋嘴鱼', '馋嘴饼']
@糊涂妹刀削面	['糊涂妹asmr']
lanzhoulamian	['兰州拉面', '兰州拉面热量', '兰州拉面的做法', '兰州拉面菜单', '兰州拉面是哪个民族', '兰州拉面图片', '兰州拉面汤料配方单', '兰州拉面粗细', '兰州拉面是哪里的', '兰州拉面排行榜']
HUAZHU-Hanting	['华住汉庭酒店wifi密码', '华住汉庭', '华住汉庭酒店', '华住汉庭官网', '华住汉庭宁波', '华住汉庭酒店数据泄漏', '华住汉庭wifi密码', '华住汉庭优惠券', '华住汉庭投诉电话', '华住汉庭电话是多少']
yuzhiguang	['欲之国太子在线读', '预制管桩', '预制管桩验收规范标准', '欲之寡欢白度云', '玉之光', '玉之光整形美容', '雨之国', '御之谷网络科技', '预制过梁']
HUAZHU_Hanting	['华住汉庭酒店wifi密码', '华住汉庭', '华住汉庭酒店', '华住汉庭官网', '华住汉庭宁波', '华住汉庭酒店数据泄漏', '华住汉庭wifi密码', '华住汉庭优惠券', '华住汉庭投诉电话', '华住汉庭电话是多少']
wangsteak	['王朔', 'wangs调味品品牌']
nanmensijishuanrou	['南门四季涮肉', '南门四季涮肉怎么样', '南门四季涮肉左家庄店', '南门四季涮肉(亚运村店)', '南门四季涮肉(芍药居北里店)怎么样', '南门四季涮肉(五棵松店)怎么样', '南门四季涮肉 立水桥', '南门四季涮肉五棵松店', '南门四季涮肉东坝店']
huajiayiyuan	['花家怡园', '花家怡园四合院', '花家怡园菜单', '花家怡园东直门店', '花家怡园圆明园店', '花家怡园惠新店', '花家怡园融科店', '花家怡园金融街店', '花家怡园清华西路店', '花家怡园四季青店']
chuanshifengge	['川师分数线', '串式风筝', '串式风筝图片大全', '传世风景二手房出售', '传世封号王爵升级表', '穿石风图片', '串式风筝简笔画幼儿', '串式风车怎么安装图解', '传世风宝', '传世风景幼儿园怎么样']
HUAZHU-Hanting.	['华住汉庭酒店wifi密码', '华住汉庭', '华住汉庭酒店', '华住汉庭官网', '华住汉庭宁波', '华住汉庭酒店数据泄漏', '华住汉庭wifi密码认证', '华住汉庭wifi密码', '华住汉庭索菲亚', '华住汉庭的密码是什么']
PizzaHut	['pizza怎么读音发音', 'pizza hut', 'pizza什么意思', 'pizza怎么读', 'pizza做法', 'pizza游戏', '披萨怎么做', 'pizzaisa', 'pizza币', 'pizza可数吗']
hongxizu	['红袖添香', '洪秀全', '洪秀柱', '红星照耀中国', '红星美凯龙', '洪学智', '红星闪耀评价', '红细胞', '红袖', '虹吸']
tuojiangxiaozhen	['沱江小镇', '沱江小镇对外经贸大学', '沱江小镇(安贞店)', '沱江小镇餐饮管理有限公司', '沱江小镇(安贞店)商户概况', '沱江小镇对外经贸']
BUU-LIB	['buuf加成是什么意思', 'buudien', 'buubei', 'buus', 'buuf换装是什么意思', 'buud', 'buupnn', 'buudien在哪']
sinopec	['sinopec', 'sinoc', 'sinopec是什么意思', '希努尔', 'sinobi', 'sinomax', 'sinofsx', 'sinobi手表是什么牌子', 'sinoc币', 'sinology']
muwushaokao	['木屋烧烤', '木屋烧烤创始人', '木屋烧烤加盟费多少', '木屋烧烤官网', '木屋烧烤菜单', '木屋烧烤营业时间', '木屋烧烤老板', '木屋烧烤店', '木屋烧烤几点海鲜半价']
伊藤洋华堂亚运村店	['伊藤洋华堂亚运村店', '伊藤洋华堂亚洲旗舰店', '伊藤洋华堂亚运村营业时间', '伊藤洋华堂亚洲新概念店', '伊藤洋华堂亚洲旗舰店招聘信息', '伊藤洋华堂亚洲第一', '伊藤洋华堂亚瑟士', '伊藤洋华堂亚洲 开业', '伊藤洋华堂亚运村店退换货', '伊藤洋华堂亚洲旗舰店2018年呈现']
bengeshousi	['本格寿司', '本格寿司 杭州', '本格寿司 北京']
bibichi	['哔哔', 'bibibi 官网', '哔哔哩哩', 'bibibi 哔哩哔哩下载', '比比皆是', 'bibi直播', '比比东', 'biubiu加速器', '笔笔攒是什么意思', '比比奇']
@茶花妹子过桥米线	['茶花妹子过桥米线', '茶花妹子过桥米线怎么样', '茶花妹子过桥米线地安门1店怎么样', '茶花妹子过桥米线(地安门1店)怎么样', '茶花妹子过桥米线 北京']
Starbucks	['starbur中文什么意思', 'starbur', 'starbucks', '星巴克', 'star布鞋', 'starbus是什么意思', 'starbur是什么意思', 'starbux', 'starbug', 'starbur什么品牌']
五指生亚运村店	['五指生亚运村店', '五指生亚运村店电话', '五指生亚运村店图片', '五指生亚运村足疗', '五指生亚健康保健中心怎么样', '五指生亚运村营业时间']
dechuanjia	['德川', '德川家康', '德川家', '德川幕府', '德川家光', '德川家族', '德川庆喜', '德川纲吉', '德川茂茂', '德川光国']
4008190099	['4008190099', '4008190488', '4008190518', '4008190770443', '4008190909', '4008190988', '4008190186']
diguashequ	['地瓜烧', '地瓜社区', '地瓜是什么', '地瓜生芽还能吃吗', '地瓜什么时候成熟', '地瓜是凉性还是热性', '地瓜是发物吗', '地瓜烧白酒', '地瓜烧酒', '地瓜是不是红薯']
交通银行信用卡	['交通银行信用卡电话', '交通银行电话', '交通银行etc', '交通银行客服', '交通银行客服电话', '交通银行app', '交通银行董事长', '交通银行网点', '交通银行官网', '交通银行招聘']
shigehuntun	['十个馄饨差不多多少克', '十个馄饨的热量', '十个混沌多少克', '十个荤菜', '十个混沌多少热量', '十个婚礼一个葬礼', '是个混油皮的粉底液', '十个婚姻九个不幸福', '是个婚礼现场唱的歌']
mengjizhoupu	['孟季仲', '孟记粥铺', '孟集中心卫生院', '孟季仲伯', '蒙几种读音组词', '孟集中心校概况']
