Huizuoshenjitang	['huizuoshenjitang']
jindingxuan	['金鼎轩', '金鼎轩菜单', '金鼎轩二公子大凡', '金鼎轩二公子', '金鼎轩地坛店', '金鼎轩菜单及价格', '金鼎轩雍和宫店地址', '金顶鲜胡羊排', '金鼎轩24小时营业', '金鼎轩团结湖店']
YummyBox1	['yummy比较级和最高级', 'yummy表情包']
zhangliangmalatang	['张亮麻辣烫', '张亮麻辣烫是谁开的', '张亮麻辣烫加盟费用', '张亮麻辣烫加盟', '张亮麻辣烫加盟费用需要多少钱', '张亮麻辣烫创始人和杨国福', '张亮麻辣烫官网', '张亮麻辣烫老板叫什么', '张亮麻辣烫百度百科', '张亮麻辣烫什么梗']
ContainerBeerShop	['containerbeershow']
zixiamen	['紫霞', '子痫', '自相矛盾', '子夏', '紫霞仙子和至尊宝', '紫霞仙子图片', '紫霞神功', '紫霞湖', '子痫前期', '自限性疾病']
金草帽炭火烤肉店	['金草帽炭火烤肉', '金草帽炭火烤肉(东五条路附近)怎么样', '金草帽炭火烤肉怎么样']
坦坦大炉望京店1	['坦坦大炉望京店', '坦坦大炉望京店怎么走', '坦坦大炉望京店 团购', '坦坦大炉望京店价格', '坦坦大炉望京烤肉店', '坦坦大炉望京店坐什么车']
cafebene	['cafebar', 'cafe杯子', '崔傲菲儿百度百科']
zhangshifu	['张少华', '张绍刚', '樟树', '张帅', '张顺', '张双利', '张圣群', '掌上明珠', '掌上东航', '章士钊']
MINGTAIYU1	['明台', '明太鱼', '明太子', '明太祖', '明太鱼干的做法大全', '铭泰', '明泰铝业', '明泰', '明太鱼是什么鱼', '明台的父亲']
裕食坊私家湘菜	['裕食坊私家湘菜怎么样']
MAZHA-JIUWU	['蚂蚱几条腿', '蚂蚱简笔画', '马扎价格', '蚂蚱酱', '蚂蚱叫声播放', '蚂蚱酱的做法', '蚂蚱叫声', '蚂蚱鸡', '蚂蚱几条腿打一数字', '蚂蚱加工怎样排便']
haolinju	['好利来', '号令天下', '好丽友', '好利来蛋糕', '好利来官网', '好邻居', '豪利时', '好利来老板', '好了歌', '豪力']
huohuozhuti	['火火中国火火时代广场舞', '火火中国梦广场舞', '火火中国风', '火火中国风广场舞茉莉', '火火中国风春英广场舞', '霍霍粥怎么做', '火火中国梦', '火火中取栗的意思', '火火中国情主持词', '霍霍正气水能洗澡吗']
TOMNTOMSCOFFEE1	['tomntomscoffee中文叫什么', 'tomntomscoffee(龙湖时代天街店)怎么样']
lazhuang	['蜡烛', '蜡烛图片', '拉珠', '蜡烛图', '蜡烛英语', '蜡烛拼音', '蜡烛人', '蜡烛包', '蜡烛简笔画', '辣庄']
Tianfujiachangcai	['天辅家长学院张莉琳', '天府家常饭店怎么样', '天辅家长学院有用吗', '天福家常菜餐馆怎么样', '天福家常菜馆(芙蓉巷店)怎么样', '天府加昌曲天姚擎羊', '天福家常菜馆怎么样', '天福家常菜馆粥·水饺城怎么样']
warawara	['warawa']
CupOne_5G	['cupone什么意思']
JinYongKTV	['金庸', '金庸小说', '金庸网', '金庸作品', '金庸群侠传', '金庸群侠传x', '金庸群侠传x攻略', '金庸武侠', '金泳勋', '金庸小说顺序']
熔时FIRESIDE	['熔时fireside评价', '熔时fireside官網', '熔时fireside连锁', '熔时fireside老板是谁', '熔时fireside加盟', '熔时fireside老板']
马路牙子地桌烤肉	['马路牙子地桌烤肉加盟']
MINGTAIYU2	['明台', '明太鱼', '明太子', '明太祖', '明太鱼干的做法大全', '铭泰', '明泰铝业', '明泰', '明太鱼是什么鱼', '明台的父亲']
TanTanDaLu	['坦坦荡荡', '坦坦大炉', '坦坦荡荡什么意思', '探探对方账号异常 不能回复消息', '谈谈对环境保护的认识', '谈谈对环境保护的认识 普通话', '坦坦荡荡做人,踏踏实实做事', '探探电话客服', '坦坦荡荡做人的句子', '探探的真实头像认证别人看得到吗']
四季民福wifi	['四季民福网上预约', '四季民福望京', '四季民福wifi密码', '四季民福王府井店预约', '四季民福武汉有吗', '四季民福王府井烤鸭店', '四季民福为什么那么火', '四季民福外卖', '四季民福旺角店电话', '四季民福望京哪家店好']
shaoxiashi	['邵夏', '烧仙草', '少校', '少先队员', '烧香', '烧香图解', '哨向', '少小离家老大回', '烧仙草热量', '烧仙草图片']
Wanrongxiaochu	['万荣笑话', '万荣笑话段子', '万荣小学', '万荣小三鼓队运城表演', '万荣小镇', '万荣小区租房', '万荣笑话七十二则', '万荣小区 物业', '万荣小区二手房价', '万榕小厨']
yiruntang	['亿润投资', '伊润藤二惊选集富江', '颐润堂望京店', '亿润投资可靠吗', '伊润藤二惊选集双一', '益润堂怎么样', '颐润堂五道口', '亿润投资集团有限公司', '颐润堂王府井', '屹润投资有限公司']
剪艺人生－中福	['剪艺人生望京中福店', '剪艺人生望京', '剪艺人生华彩店电话', '剪艺人生理发店怎么样', '剪艺人生怎么样', '剪艺人生望京夏都店', '剪艺人生西门子', '剪艺人生将台路店', '剪艺人生现在什么价位', '剪艺人生 价格']
kuaikan_soho	['快看视频', '快看视频app苹果', '快看上特别污的漫画', '快看视频app官网', '快看上什么腐漫好看', '快看世界', '快看世界北京科技有限公司', '快看视界激活码', '快看视频.m3u8', '快看商城']
huangtucheng	['黄土成语', '黄土尘埃已消遁猜一肖', '皇土成语', '黄土成分', '黄土城', '黄土沉香多少钱一克', '黄土城站', '黄土尘埃已消遁什生肖', '黄土朝天', '黄土城到延庆']
hongjingyu	['洪金宝', '红景天', '红警', '红景天口服液', '洪金宝电影', '红景天的功效与作用', '红警3', '红金龙', '洪金权', '红景天价格']
HanTing	['寒天', '韩童生', '韩天宇', '汉庭', '汉庭酒店', '汉天子', '旱獭', '憨态可掬', '寒天帝', 'hanteo']
wangjingxiaoyao	['望京小腰', '望京小腰是什么腰子', '望京小腰图片', '望京小腰加盟多少钱', '望京小腰总店', '望京小腰加盟', '望京小腰哪家是真的', '望京小腰做法', '望京小腰总店在哪', '望京小腰怎么样']
yixuanjiaozi	['奕炫价格', '一轩饺子馆', '艺轩教育', '忆璇教你蹦迪全第一集', '一轩饺子馆 望京', '伊萱佳人化妆品怎么样', '艺轩家具', '忆璇教你蹦迪二十六', '易萱减肥', '忆璇教你蹦迪一']
BARSAK1	['bars是什么意思', 'bars疗愈骗局', 'barsh', 'bar是什么意思', 'bars疗愈', 'barstow', 'barsh手表', 'barstool', 'bar是什么单位', 'bershka']
Baihualin	['白话', '白化病', '白桦林', '白桦树', '白皇后', '百花奖', '白话文', '百花奖张译输给李易峰', '百花山', '百花']
qihuannuanwu	['奇幻暖暖公主图片', '奇幻暖暖图片大全']
luckincoffee-Guest	['luckincoffee-guest', 'luckincoffee广州门店', 'luckincoffee果汁口味', 'luckincoffee广告百度云', 'luckincoffee广告视频', 'luckincoffee广告费多少', 'luckincoffee关门了', 'luckincoffee光谷创业街位置']
caffebene	['caffe编译matlab接口']
火齐潮汕砂锅粥	['火齐潮汕粥', '火齐潮汕砂锅粥菜单', '火齐潮汕砂锅粥怎么样', '火齐潮汕砂锅粥(国贸店)怎么样', '火齐潮汕砂锅粥(木樨园店)怎么样', '火齐潮汕砂锅粥(合生汇店)怎么样', '火齐潮汕砂锅粥价目表', '火齐潮汕砂锅粥(太阳宫凯德店)怎么样', '火齐潮汕砂锅粥加盟费', '火齐潮汕砂锅粥(慈云寺店)怎么样']
sijiminfu	['四季民福', '四季民福烤鸭店', '四季民福烤鸭', '四季民福故宫店', '四季民福烤鸭店预约', '四季名店', '四季民福烤鸭店必点菜', '四季民福菜单价格表', '四集迷你剧千里送子', '四季明福烤鸭店怎么样']
yunhaiyao	['云海', '云海金属', '云海玉弓缘', '云海肴', '云海中的风', '云海翻腾孙悟空', '云海山庄', '云海牧鲲', '云海仙踪', '晕海']
xiaoshiguangmang	['小时光免费观看', '小时光灭绝', '消逝光芒', '小时光免费阅读', '小时光面馆', '小时光免费', '消逝光芒最后剧情', '小时光面膜', '小时光免费网站']
bibigo_soho	['bibigo是要撤出中国吗']
duolezhiri	['多乐之日', '多乐之日官网', '多乐之日蛋糕', '多乐中国象棋下载', '多乐中国象棋', '多乐之日加盟费多少钱', '多乐中国象棋手机版', '多乐中国象棋官方下载', '多乐之日蛋糕订购', '多乐之日蛋糕价格表']
剪艺人生-夏都	['剪艺人生望京中福店', '剪艺人生望京', '剪艺人生华彩店电话', '剪艺人生理发店怎么样', '剪艺人生怎么样', '剪艺人生望京夏都店', '剪艺人生西门子', '剪艺人生将台路店', '剪艺人生现在什么价位', '剪艺人生 价格']
pangzilongxia5	['胖子龙虾', '胖子龙虾马家堡店', '胖子龙虾宋家庄店', '胖子龙虾石景山店', '胖子龙虾望京店', '胖子龙虾石景山店电话', '胖子龙虾七克拉店菜单', '胖子龙虾老板是谁', '胖子龙虾大屯路店', '胖子龙虾大屯店']
MrPIZZA	['mrpii', 'mrpizza', 'mr平扫', 'mrpizza是什么品牌', 'mrpizza官网', 'mrpizza和必胜客', 'mr平扫是什么检查', 'mrpii的基本思想和特点是什么', 'mr平扫是不是磁共振', 'mr披萨官网']
kangyunyangsheng	['康云养生堂', '康韵养生会馆正规吗', '康韵养生馆怎么样', '康韵养生会馆十里河', '康韵养生会馆 概况', '康韵养生会所怎么样', '康韵养生会馆 评论']
多乐之日望京SOHO店	['多乐之日望京soho哪个面包好吃']
LaTercera	['later创作的原声', 'later词根']
一个叫川的地方	['一个叫川的地方北京', '一个叫川的地方官网', '一个叫川的地方南昌', '一个叫川的地方谁开的']
huohuozhuti2	['火火猪', '火火烛烛的意思', '活活捉一只麻烦精']
zhuluchalou	['逐鹿茶楼学院路店', '逐鹿茶楼', '逐鹿茶楼西直门店', '逐鹿茶楼望京', '逐鹿茶楼知春路店', '猪碌肠', '逐鹿茶楼贵足会正规吗', '逐鹿茶楼明光桥店', '逐鹿茶楼路六道口', '猪碌肠是什么']
HuoLuHuo	['火炉', '霍乱', '霍乱时期的爱情', '活络油', '火炉城市', '火炉火', '霍乱江湖', '货轮', '活络', '霍乱弧菌']
WARAWARA	['warawa']
