PizzaNow	['pizzano', 'pizza能放多久', 'pizza能放一天吗', 'pizza哪个好吃', 'pizza能不能第二天吃', 'lipizzan']
HaiDiLaoDianCai	['海底捞点菜攻略', '海底捞点餐攻略', '海底捞点菜攻略2人', '海底捞店长日记', '海底捞点餐', '海底捞点菜', '海底捞点菜的平板咋用', '海底捞点餐系统', '海底捞点餐技巧', '海底捞点菜都是ipad']
Jindingxuan	['金鼎轩', '金鼎轩二公子大凡', '金鼎轩菜单', '金鼎轩二公子', '金鼎轩地坛店', '金鼎轩菜单及价格', '金鼎轩雍和宫店地址', '金鼎轩24小时营业', '金鼎轩团结湖店', '金鼎轩方庄店电话']
PizzaHut	['pizza火币', 'pizza盒子能进微波炉', 'pizza汉语意思是什么', 'pizza烘烤温度时间', 'pizza盒子设计这样用', 'pizza好消化吗', 'pizza汉语', 'pizza烘焙', 'pizza黄游', 'pizza黄游戏']
jindingxuan	['金鼎轩', '金鼎轩二公子大凡', '金鼎轩菜单', '金鼎轩二公子', '金鼎轩地坛店', '金鼎轩菜单及价格', '金鼎轩雍和宫店地址', '金鼎轩24小时营业', '金鼎轩团结湖店', '金鼎轩方庄店电话']
xiaotudou...	['小土豆怎么做好吃', '小土豆的做法', '小土豆', '小土豆咸菜的做法', '小土豆奶瓶怎么样', '小土豆扣奥尼尔视频', '小土豆怎么去皮', '小土豆隔扣奥尼尔视频', '小土豆奶瓶', '小土豆的做法大全家常']
qiaowaipo	['侨外移民', '侨外出国', '俏歪嘴5.5休闲食品加盟多少钱', '俏歪嘴5.5休闲食品怎么样', '俏歪嘴6.6', '侨外移民正规吗', '乔外婆麻辣香锅铁营桥', '俏歪嘴休闲食品进价表', '俏歪嘴休闲食品加盟', '俏歪嘴食品加盟骗局']
YJXCGY	['艳决乡村', '眼睑下垂', '月经血呈黑色', '异界小厨仙', '眼角下垂', '夜间行车开什么灯', '义井小吃街搬哪了', '眼睑下垂图片', '眼角下垂面相', '豫剧下陈州全场']
Honda	['honey', 'honor', 'honest', '鸿蒙', '红花会', '红旗', '红豆', '红楼梦', '红烧肉', '洪门']
Starbucks	['starbucks', '星巴克', '抖音那个starbuc']
zhengyuanyuan	['郑远元', '郑媛媛', '郑远元专业修脚房', '郑远元专业修脚房加盟', '郑远元治灰指甲真实吗', '郑远元专业修脚房附近', '郑远元专业修脚房怎么样', '郑原玉432', '郑远元修脚房价格表图', '郑远元专业修脚店']
7daysInn	['7daysin']
@百万庄园方庄店	['百万庄园方庄店']
方庄物业大厦	['方庄物业电话号码', '方庄物业公司电话', '方庄物业维修电话号码', '方庄物业第一分公司', '方庄物业维修电话', '方庄物业管理公司', '方庄物业东惠家园电话', '方庄物业客服', '方庄物业投诉电话', '北京方庄物业']
xiaotudou..	['小土豆', '小土豆的做法', '小土豆怎么做好吃', '小土豆去皮', '小土豆咸菜的做法', '小土豆奶瓶怎么样', '小土豆咸菜', '小土豆英文', '小土豆nba', '小土豆是谁']
小龙坎老火锅	['小龙坎老火锅', '小龙坎老火锅使用老油', '小龙坎老油反复用视频', '小龙坎老油反复用', '小龙坎老火锅回收油', '小龙坎老火锅事件', '小龙坎老火锅后厨', '小龙坎老火锅加盟费', '小龙坎老火锅怎么样', '小龙坎老火锅官网']
味多美刘家窑地铁店	['味多美刘家窑地铁店']
HaiDiLaoHuoGuo	['海底捞火锅', '海底捞火锅加盟', '海底捞火锅价格表', '海底捞火锅底料', '海底捞火锅加盟费多少', '海底捞火锅怎么吃', '海底捞火锅成立于哪一年', '海底捞火锅底料怎么调', '海底捞火锅底料哪个好吃', '海底捞火锅加盟费吗']
CNODDT	['cnodc', 'cnode', 'cnodc的全称是什么', 'cnodc西非公司', 'cnodc招聘', 'cnodc海外板块', 'cnodc招聘有因为体检', 'cnodc内部招聘笔试', 'cnodc一把手', 'cnodc与中油国际关系']
LAOBAOSAN	['老爆三', '老爆三的做法', '劳保所', '劳保手套', '劳保是什么意思', '劳保所是干什么的', '劳保手套批发价格', '老保是什么意思', '老鸨是什么鸟', '老爆三是什么']
99inn	['99inn.cc', '99inn无线网登录', '99img怎么用', '99img', '99i是什么意思', 'c122699i', '三星i699i', '足金999i', 'motorola mt99i', '周大福足金999i']
鸿运天外天	['鸿运天成', '鸿运天成什么意思', '鸿运天桥', '鸿运天降陆原', '鸿运天降小说', '鸿运天外天烤鸭店', '鸿运天成公司', '鸿运天成这个成语解释', '鸿运天狼星三头', '鸿运天成画的寓意']
为美好相聚沸腾	['为美好相聚沸腾']
dawanju	['大腕', '大王卡', '大湾区', '大碗宽面', '大王饶命', '大王', '大玩家', '大王蛇', '大王花', '大碗']
YLKYD	['缘来客', '伊拉克', '伊莱克斯', '伊拉克战争', '缘来客手机登录会员', '元利科技', '悦来客栈', '英伦咖', '伊莱克斯空调', '伊莱克斯冰箱']
Yoshinoya	['yoshino号巡洋舰', 'yoshino是什么意思', 'yoshino战舰世界', 'yoshino巡洋舰', 'yoshino吉野', 'yoshino日语是什么', '日本yoshino']
ChunBingKaoYaDian	['春饼烤鸭店', '春饼烤鸭店(刘家窑顺三条店)怎么样', '春饼烤鸭店(刘家窑顺三条店)', '春饼烤鸭店推荐顺四条', '春饼烤鸭店刘家窑店', '春饼烤鸭店的电话号码?', '春饼烤鸭店(方庄店)怎么样']
Laochengyiguo	['老城一锅', '老城一锅羊蝎子', '老城一锅羊蝎子加盟', '老城一锅羊蝎子火锅加盟费多少', '老诚一锅羊蝎子', '老城一锅羊蝎子做法', '老诚一锅和老城一锅', '老诚一锅羊蝎子加盟费多少', '老诚一锅羊蝎子火锅加盟', '老城一锅电话']
ZGGJWJY	['中国歌剧舞剧院', '中国歌剧舞剧院考级证书有效吗', '壮骨关节丸', '中国国籍为什么难入', '中国歌剧舞剧院考级', '中国歌剧舞剧院考级证书查询', '壮骨关节丸的功效用途', '中国国际文化传播中心', '中国国际问题研究院', '中国国家未来的名片']
西贝莜面村	['西贝莜面村', '西贝莜面村12个必点菜', '西贝莜面村怎么念', '西贝莜面村让加盟吗', '西贝莜面加盟费', '西贝莜面事件', '西贝莜面村创始人', '西贝莜面村菜品图片', '西贝莜面村400电话号码', '西贝莜面里什么菜好吃']
HaiYinHaiJi	['海银海记', '海银海记潮汕火锅', '海银海记潮汕牛肉火锅', '海银海记菜单', '海银海记电话', '海银海记牛肉', '海银海记上市了吗', '海银海记保山', '海银海记 美股', '海印海印股份股吧']
7daysinn	['7daysin']
诚记鲜牛肉火锅	['诚记鲜牛肉火锅']
Sinopec	['sinopec', 'sinopec是什么意思', 'sinopay', 'sinopac', 'sinopecsales.co m', 'sinopec全称', 'sinope', 'sinoped', 'sinophile', 'sinoppe']
北京何所有酒店	['北京何所有酒店电话', '北京何所有酒店刘家窑', '北京何所有酒店怎么样', '北京何所有酒店地址', '北京何所有酒店 几星', '北京何所有酒店招聘', '北京何所有酒店到北京南站打车', '北京何所有酒店图片', '北京何所有酒店 南站']
bingchengBBQ	['槟城壁画', '槟城壁画街地址', '秉承不忘初心牢记使命', '槟城壁画街', '槟城白咖喱面', '槟城白咖啡怎么样', '槟城壁画地图', '冰城堡的英文', '槟城壁画集中在哪里', '槟城百度百科']
dinghaishenzhen	['定海神针', '定海神针清屏专用超长', '定海神针刷屏', '定海神针比喻什么意思', '定海神针是成语吗', '定海神珍', '定海神针图片', '定海神针软件', '定海神珠', '定海神针是什么意思']
HomeInns	['homeinn', 'homeinn什么意思', 'homeins']
julongwatankaoyangtui1	['聚龙娃炭烤羊腿(平谷店)(平谷店)怎么样', '聚龙娃炭烤羊腿(临江店)怎么样', '聚龙娃炭烤羊腿(京东旗舰店)怎么样', '聚龙娃碳烤羊腿(刘家窑店)商户概况', '聚龙娃炭烤羊腿京东旗舰店怎么样', '聚龙娃碳烤羊腿(机场店)怎么样', '聚龙娃炭烤羊腿(郑州总店)怎么样', '聚龙娃炭烤羊腿(刘家窑店)怎么样']
