HaiDiLaoDianCai	['海底捞点菜攻略', '海底捞点餐攻略', '海底捞点菜攻略2人', '海底捞店长日记', '海底捞点餐', '海底捞点菜', '海底捞点菜的平板咋用', '海底捞点餐系统', '海底捞点餐技巧', '海底捞点菜都是ipad']
CHAOZHOUHUI	['潮州话', '潮州话翻译', '潮州话在线发音', '潮州恒星水上乐园', '潮州韩文公祠', '潮州韩文公庙碑', '潮州和潮汕的区别', '潮州韩山师范大学', '潮州话骂人经典的100句', '潮州恒大城']
NOVOTEL	['novotel', 'novotel酒店几星', 'novotel是什么意思', 'novotel酒店', 'novotel酒店 上海', 'novotek', 'novotel上海', 'novotel新加坡', 'novotel泰国', 'novotel首尔']
siyeniula	['四爷牛拉', '四爷牛拉总店在哪', '四爷牛拉面门店', '四爷牛拉是清真的吗', '四爷钮祜禄小说', '四爷牛拉创始人', '四爷牛拉创始人吴熙花']
hehuatai	['荷花头像', '荷花图', '荷花塘', '荷花亭', '荷花图片大全 高清', '荷花头像图片 微信', '荷花特点', '荷花图片手绘 简笔画', '荷花图片带字', '荷花头像代表什么意思']
jiangtaiwuer	['姜泰伍', '将太无二', '将太无二菜单价目表', '将太无二北京店', '将太无二什么意思', '将太无二菜单', '将太无二什么档次', '将太无二是自助吗', '将太无二加盟费', '将太无加盟']
Joyinn	['joying', 'joyice', 'joying什么意思', '记忆重构', 'joyins', 'jo英文名', 'joyi怎么读', 'joyinn', 'joyi是什么意思中文', 'joying五羊本田']
戈拿旺巴西烤肉	['戈拿旺巴西烤肉自助餐', '戈拿旺巴西烤肉菜市口店', '戈拿旺巴西烤肉价钱', '戈拿旺巴西烤肉团购', '戈拿旺巴西烤肉表演', '戈拿旺巴西烤肉亚运村', '戈拿旺巴西烤肉(亚运村直营店)怎么样', '戈拿旺巴西烤肉(崇文门店)', '戈拿旺巴西烤肉(亚运村直营店)', '戈拿旺巴西烤肉(菜市口店)商户概况']
Guangming-Daily	['光明代码密室逃脱攻略', '光明代码密室逃脱', '光明代言人', '光明代码', '光明代码密室逃脱遗失的宝藏攻略', '光明大王椰', '光明袋装酸牛奶', '光明代表什么', '光明大王椰商标', '光明代码 遗失的宝藏']
njdpd	['南京大学', '牛津大学', '南京大学金陵学院', '南京地铁贴吧', '南京大牌档', '南京地图', '你的名字', '南京地铁线路图']
McDonald's	['麦当劳']
hankoujietou	['汉口街头', '汉口街头 太阳宫', '汉口街头 国瑞城店', '汉口街头 大众点评']
Novotel-XinQiao	['novotel新桥酒店']
WAGAS	['wage', 'wagon', 'wagas', 'wages', '瓦格纳', '哇嘎', 'wait', 'wago', 'wagyun', 'wagner']
DingJunHui	['丁俊晖', '丁俊晖2019最新比赛', '丁俊晖最新比赛消息', '丁俊晖吧', '丁俊晖比赛', '丁俊晖直播', '丁俊晖2019最新排名', '丁俊晖147']
tiancifuyuan1	['天赐福缘', '天赐福缘是什么意思', '天赐福院酒店怎么样', '天赐福院四合院酒店']
Super8	['super', 'super junior', 'superior', 'supermarket', 'superb', 'superman', 'superm', 'supervision', 'superficial', 'superhero']
hankunlaw	['汉坤律师事务所', '汉坤律师事务所排名', '汉坤律师事务所刘冬', '汉坤利器狂飞', '汉坤律所 葛音', '汉昆律所三位创始人', '汉坤律师', '汉坤律师事务所官网', '汉坤鲤二代钓鱼竿', '汉坤律师事务所待遇']
HaiDiLaoHuoGuo	['海底捞火锅', '海底捞火锅加盟', '海底捞火锅价格表', '海底捞火锅底料', '海底捞火锅加盟费多少', '海底捞火锅怎么吃', '海底捞火锅成立于哪一年', '海底捞火锅底料怎么调', '海底捞火锅底料哪个好吃', '海底捞火锅加盟费吗']
mingshiguang	['茗视光', '明日花', '茗视光眼科医院', '茗视光眼科医院好不好', '铭仕管业', '名士官网', '茗视光眼科医院地址', '命时乖', '茗视光眼科医院电话', '名仕观邸']
yunhaiyao	['云海肴', '云海玉弓缘', '云海苑', '云海玉弓缘小说', '云海玉弓缘20集国语', '云海玉弓缘小说阅读', '云海肴菜单', '云海肴创始人', '云海玉弓缘电视剧', '云海玉弓缘在线观看']
huachengshishang	['华程时尚酒店', '华诚食尚酒店地址', '花城时尚酒店', '华程时尚酒店的地图', '花城是啥', '华程时尚宾馆怎么样', '花城时尚酒店怎么样', '华城食尚酒店怎么样', '华程时尚酒店(北京崇文门地铁站店)怎么样', '华诚时尚自助火锅城怎么样']
99inn.cc	['99inn.cc', '99inn无线网登录']
BlueNoteBJ	['blue note 北京', 'blue note jazz club', 'blue note 上海', 'blue note 北京官网', 'blue notes香水', 'blue note jazz 北京', 'blue notes香水多少钱', 'blue note 上海地址', 'blue note是什么意思', 'blue notes 爵士']
rongchengguli	['榕城古街', '荣成鼓浪屿洗浴搬那里', '荣成鬼城', '荣城国际丹阳', '荣城国际', '荣成国际海水浴场', '荣成广电宽带客服电话', '榕城广场', '融城国际滕州最新消息', '荣成郭永怀纪念馆']
便宜坊哈德门店	['便宜坊哈德门店电话', '便宜坊哈德门', '便宜坊哈德门怎么样', '便宜坊哈德门店地铁', '便宜坊哈德门烤鸭店怎么样', '便宜坊哈德门店特色菜', '便宜坊哈德门店需要排队不', '便宜坊哈德门店地址', '便宜坊哈德门和新世界店']
Novotel_XinQiao	['novotel新桥酒店']
beautyfarm	['beauty翻译', 'beauty翻译中文', 'beauty发音', 'beauty防晒霜排名']
FamilyMart	['family漫画']
BlueNote	['blue note 北京', 'blue浓香和淡香的区别']
wendingfu	['问鼎', '问鼎中原', '稳定', '稳定器', '问鼎巅峰', '稳定性', '文定', '问鼎江湖', '稳定剂', '稳定的英文']
fenglianbinguan	['烽联宾馆']
HuoLuHuo	['火炉火', '火炉火自助', '火鹿灬念什么', '火炉火加盟费', '火炉火自助是随便点吗', '火炉火南瓜粥的做法', '火炉火烤肉', '活芦荟可以直接涂脸吗', '火炉火菜单', '火炉火自助多少钱']
99inn.cn	['99inn.cc', '99inn无线网登录']
dadongkyd	['大董烤鸭店', '大董烤鸭多少钱一只', '大董烤鸭店菜单价格表', '大董烤鸭店地址', '大董烤鸭店人均消费', '大董烤鸭店价目表2019', '大董烤鸭店工体店地址', '大董烤鸭菜单', '大董烤鸭工体店']
为美好相聚沸腾	['为美好相聚沸腾']
tiancifuyuan3	['天赐福缘', '天赐福缘是什么意思', '天赐福院酒店怎么样', '天赐福院四合院酒店']
