LunYuCunZhuang.	['轮雨村庄', '轮雨村庄之禁忌游戏', '轮雨村庄(天鹅湾店)怎么样']
AppleStore	['app了store', 'app了store无法连接怎么办', 'app了store验证码老是白的', 'app了store无法登录', 'apple store无法下载', 'apple store怎么改成中文', 'apple store自动扣费', 'apple store无法连接', 'app了store是什么意思', 'app了store打不开']
vika1	['viking', 'viki', 'vikasu', 'vikki', 'vika', 'vikey', 'vike', 'viky', 'vicky', 'village']
UYOUNG	['u友', 'u友卡', 'u友爱施德', 'u友客服', 'u友营业厅', 'u优居', 'u有几种发音', 'u友缘', 'u优读app', 'u友客服电话是多少']
ChateauStarRiver	['chateaustarriver.com']
QianZiLian-2	['千子莲', '千子莲足道', '千子莲足道有飞机吗', '嵌字联', '钱自亮', '钱字亮', '倩字连笔签名设计', '倩字连笔签名', '千子莲足疗会所怎么样', '千子莲珠江帝景店足疗']
homeinns3	['homeinn什么意思']
Bankcomm	['bankcomm.com', 'bank code什么意思']
homeinns2	['homeinn什么意思']
TangGong	['唐功红', '唐宫', '唐宫燕', '汤沟', '唐宫美人天下', '唐宫仕女图', '唐狗', '唐功红七窍流血视频', '唐宫原著', '唐宫海鲜舫']
chaoyangjianshen	['朝阳建设集团有限公司', '朝阳建设银行', '朝阳健身操', '潮阳建设银行工作时间', '朝阳健身房月卡价格表', '朝阳健身房', '朝阳建市时间', '朝阳建设银行网点', '朝阳健身操第十二套', '潮阳健身房']
眉州东坡酒楼	['眉州东坡酒楼', '眉州东坡菜单', '眉州东坡酒楼电话', '眉州东坡集团', '眉州东坡网上订餐', '眉州东坡酒楼菜单', '眉州东坡电话', '眉州东坡官网', '眉州东坡小吃', '眉州东坡门头沟']
聚点串吧-甘露园店	['聚点串吧甘露园店']
jazz.ya	['jazz是什么舞种', 'jazz是什么意思中文翻译', 'jazz funk是什么舞种', 'jazz舞', 'jazzcat舞蹈考级视频', 'jazz hippo', 'jazz怎么读的', 'jazz是什么意思中文', 'jazz本田', 'jazz分类']
AMBER	['amber', 'ambition', 'ambulance', 'ambush', 'ambiguous', 'ambitious', 'ambassador', 'ambient', 'ambiguity', 'amc']
眉州东坡-12	['眉州东坡酒楼', '眉州东坡酒楼电话', '眉州东坡酒楼菜单', '眉州东坡酒楼顺义店', '眉州东坡必点菜', '眉州东坡亦庄店电话', '眉州东坡草桥店电话', '眉州东坡王刚', '眉州东坡酒楼亦庄店', '眉州东坡酒楼官网']
rujia	['乳交', '如家', '乳胶漆', '乳胶', '儒家', '乳胶枕', '乳胶床垫', '如家酒店', 'rule', '乳胶衣']
太平洋咖啡	['太平洋保险', '太平洋汽车网', '太平洋战争', '太平洋车险', '太平洋汽车', '太平洋保险电话', '太平洋保险公司', '太平洋电脑网', '太平洋保险怎么样', '太平洋建设']
YFJAZZ	['约分教案', '洋房建安成本一般多少', '语法教案', '衣服加氨纶的作用', '右腹肌按压疼', '约分教案导入', '孕妇脚爱出汗臭怎么办', '右腹肌按痛持续好久', '孕妇就爱吃西瓜怎么办', '孕妇级安全标准标志']
CMCC-WEB	['cmccweb是什么网络', 'cmccweb收费吗', 'cmccweb', 'cmccweb怎么免费连接', 'cmccweb免费账号密码', 'cmccweb登录界面', 'cmccweb怎么连接', 'cmcc网络怎么连接', 'cmcc网络', 'cmcc无线网']
100inn	['100iu', '100米', '100iu等于多少毫克', '100iu/ml', '100iu是什么意思', '100inch', '100iu等于多少ml', '100iu ug', '100iu等于多少mg']
qianzilianzudao	['千子莲足道', '千子莲足道有飞机吗', '千子莲足道消费价格', '千子莲足道怎么样', '千姿莲足道', '千子莲足道(金牛街荷塘月色店)怎么样', '千子莲足道(亦庄分店)怎么样', '千子莲足道有小姐吗', '千子莲足道(木樨园店)怎么样', '千子莲足道(西矿街店)怎么样']
HUAZHU-Hanting	['华住汉庭酒店wifi密码', '华住汉庭', '华住汉庭酒店', '华住汉庭官网', '华住汉庭宁波', '华住汉庭酒店数据泄漏', '华住汉庭wifi密码认证', '华住汉庭wifi密码', '华住汉庭索菲亚', '华住汉庭的密码是什么']
7daysInn	['7daysin']
misshuo	['missha', 'missing', 'misshapen', 'missha是什么牌子', 'mission', 'missile', 'missing you', 'miss和ms', 'missho潇潇洒洒', 'mis是什么意思']
tianehui	['天鹅湖', '天鹅湖芭蕾舞', '天鹅湖花园', '天鹅湖万达', '天鹅湖大酒店', '天鹅湖故事', '天鹅湖作者', '天鹅湖在哪里', '天鹅湖景区', '天鹅湖草原']
HI辣火锅	['hi辣火锅', 'hi辣火锅创始人', 'hi辣小龙虾', 'hi辣火锅邓家佳官网', 'hi辣火锅在哪些城市', 'hi辣火锅加盟费', 'hi辣火锅价目表', 'hi辣小龙虾怎么样', 'hi辣火锅北京哪里有', 'hi辣火锅北京地址']
24小时自助图书馆	['24小时自助图书馆书籍多吗', '24小时自助图书馆', '24小时自助图书馆怎么使用', '24小时自助图书机', '24小时自助图书馆加盟', '24小时自助图书馆费用', '24小时自助图书馆退卡', '24小时自助图书馆(大东门街分馆)怎么样', '24小时自助图书馆 评论']
JuZiShu_QNL	['桔子树麒麟', '桔子树麒麟系列', '桔子树麒麟百度云', '橘子树麒麟', '桔子树麒麟在线观看', '桔子树麒麟系列时间线', '桔子树青年路校区电话', '桔子树缺微量元素图片', '桔子树扦插技术视频', '桔子树潜叶蛾用什么药']
chongqingxiaomian	['重庆小面', '重庆小面的做法', '重庆小面加盟店', '重庆小面的做法及配料', '重庆小面图片', '重庆小面培训哪家最好', '重庆小面加盟费多少钱', '重庆小面加盟要多少钱', '重庆小米熊儿童医院口碑']
jinshoushao	['金手勺', '金寿山', '金首饰', '金首饰价格', '金首饰回收', '金首饰怎么清洗才亮', '金手勺东北菜', '金首饰哪个牌子好', '金寿什么字', '进手术室流程']
shishangmatou	['时尚码头全国连锁店', '时尚码头', '时尚码头美容美发', '时尚码头北京连锁店', '时尚码头姚金虎董事长', '时尚码头东坝店', '时尚码头股权合同', '时尚码头商学院股权', '时尚码头青年路店', '时尚码头宋家庄店']
LunYuCunZhuang2	['轮雨村庄', '轮雨村庄之禁忌游戏', '轮雨村庄(天鹅湾店)怎么样']
ziroom	['ziroom', '自融', 'ziroom自如', '自如', 'ziroom默认wifi密码', 'zero', '姿容', 'zircon', 'ziro运动控制系统', '自若']
MeowCafe	['meowcat']
QianZiLian-1	['千子莲', '千子莲足道', '千子莲足道有飞机吗', '嵌字联', '钱自亮', '钱字亮', '倩字连笔签名设计', '倩字连笔签名', '千子莲足疗会所怎么样', '千子莲珠江帝景店足疗']
PizzaHut	['pizza火币', 'pizza盒子能进微波炉', 'pizza汉语意思是什么', 'pizza烘烤温度时间', 'pizza盒子设计这样用', 'pizza好消化吗', 'pizza汉语', 'pizza烘焙', 'pizza黄游', 'pizza黄游戏']
LunYuCunZhuang3	['轮雨村庄', '轮雨村庄之禁忌游戏', '轮雨村庄(天鹅湾店)怎么样']
@全羊肉泡馍	['全羊肉馆菜谱大全', '全羊肉汤的做法大全', '全羊肉包装纸箱图片', '全羊肉的结构图', '全羊肉汤的做法及配料', '全羊肉市场价格', '全羊肉怎么做好吃', '全羊肉的图片', '烤全羊肉', '羊肉的做法大全羊肉']
.@博成雅居酒楼	['博成雅居酒楼', '博成雅居青年路', '北京博成雅居']
PUPPY_TOWN	['puppy投影仪官网']
huaniucanguan	['花牛餐馆']
WX-QJD	['武心潜龙全文免费阅读', '微信群发所有人怎么发', '无限气运主宰', '微信群', '微信情侣头像', '微信签名一句话至自己', '微信签名', '微信群收款怎么弄', '微信群名', '微信群发']
runjiangnan2	['润江南朝阳大悦城店', '润江南', '润江南旅行社', '润江南旅行社怎么样', '润江南 订餐 电话', '润江南热水器', '润江南倒闭', '润江南热水器安装', '润江南餐厅怎么样']
LianJia	['链家', '链家网', '链接', '脸基尼', '连襟', '脸颊', '联机游戏', '连江前天发生一起车祸', '廉晶雅', '练俊杰']
HEYTEA	['heytea', 'heytea喜茶 官网', 'heytea是什么意思', '耗儿鱼图片', 'heytea喜茶加盟吗', 'heytea喜茶', 'heytea喜茶加盟费大概多少', 'heytea怎么读', '海尔一拖三中央空调', '海尔一拖一风管机报e5']
Starbucks	['starbucks', '星巴克', '抖音那个starbuc']
bianlifeng	['便利蜂', '便利蜂加盟费多少', '便利蜂官网', '便利蜂招聘', '便利蜂优惠券', '便利蜂工资怎么那么高', '便利蜂连锁便利店', '便利蜂加盟费', '便利蜂加盟', '便利蜂app']
weishiguang	['胃食管反流', '胃食管反流病的症状', '胃食管反流吃什么药', '唯时光与你不可辜负', '胃食管反流怎么冶', '胃食管反流病怎么治', '胃食管反流病能治好吗', '胃食管反流病的症状吃什么药', '胃食管反流的治疗', '胃食管反流病能活多久']
Waipojia	['外婆家', '外婆家菜单', '外婆家加盟费多少', '外婆家必点招牌菜', '外婆家老板', '外婆家官网', '外婆居', '外婆家地址', '外婆家招牌菜', '外婆家外卖']
西贝莜面村	['西贝莜面村', '西贝莜面村12个必点菜', '西贝莜面村怎么念', '西贝莜面村让加盟吗', '西贝莜面加盟费', '西贝莜面事件', '西贝莜面村创始人', '西贝莜面村菜品图片', '西贝莜面村400电话号码', '西贝莜面里什么菜好吃']
WAGAS	['wage', 'wagon', 'wagas', 'wages', '瓦格纳', '哇嘎', 'wait', 'wago', 'wagyun', 'wagner']
amber	['amber', 'ambition', 'ambulance', 'ambush', 'ambiguous', 'ambitious', 'ambassador', 'ambient', 'ambiguity', 'amc']
BJLYFCYY	['北京俪婴妇产医院价格', '北京俪婴妇产医院人流', '北京露营房车展', '毕节利亚房产', '北京俪婴妇产医院招聘', '保加利亚房产投资', '北京六月份穿衣服图片', '北京俪婴妇产医院消费', '北京丽樱妇产医院', '北京旅游翡翠购物店']
runjiangnan	['润江南朝阳大悦城店', '润江南', '润江南旅行社', '润江南旅行社怎么样', '润江南 订餐 电话', '润江南倒闭', '润江南热水器', '润江南热水器怎么安装', '润江南餐厅怎么样']
DiaoYeniunan	['雕爷牛腩', '雕爷牛腩失败的原因', '雕爷牛腩创始人', '雕爷牛腩现状', '雕爷牛腩菜单价目表', '雕爷牛腩现状2019', '雕爷牛腩西安店', '雕爷牛腩筷子', '雕爷牛腩老板', '雕爷牛腩外卖图片']
xianaohui	['仙傲好看吗', '虾脑红色怎么洗掉', '西安奥华', '西安奥恒科技有限公司', '仙傲和大道独行的联系', '西安凹痕修复', '西安奥辉纸业张孝普', '西安奥辉纸厂', '仙傲和大道独行', '西安奥汉国际']
BEERALL	['beeray', 'beerall']
homeinns	['homeinn', 'homeinn什么意思', 'homeins']
XuePankaochuan	['薛蟠烤串', '薛蟠烤串 张艺兴', '薛蟠烤串为什么叫薛蟠', '薛蟠烤串老板是谁', '薛蟠烤串官网', '薛蟠烤串(朝阳大悦城店)', '薛蟠烤串(蓝色港湾店)', '薛蟠烤串(朝阳大悦城店)网友评论', '薛潘烤串 大悦城', '薛蟠烤串是谁开的']
yingpaisijianshen	['英派斯健身', '英派斯健身年卡价格表', '英派斯健身器材', '英派斯健身俱乐部', '英派斯健身价格', '英派斯健身电话', '英派斯健身怎么样', '英派斯健身器材价格', '英派斯健身官网', '英派斯健身全国多少家']
xiaojungan	['小郡肝', '小军鼓', '萧敬腾', '小郡肝是什么', '小郡肝串串香', '肖俊光', '小郡肝串串', '小郡肝 jiameng.com', '小郡肝加盟费', '小郡肝串串香加盟骗局']
