jindingxuan	['金鼎轩', '金鼎轩二公子大凡', '金鼎轩菜单', '金鼎轩二公子', '金鼎轩地坛店', '金鼎轩菜单及价格', '金鼎轩雍和宫店地址', '金鼎轩24小时营业', '金鼎轩团结湖店', '金鼎轩方庄店电话']
zhangliangmalatang	['张亮麻辣烫', '张亮麻辣烫是谁开的', '张亮麻辣烫加盟费用', '张亮麻辣烫加盟', '张亮麻辣烫加盟费用需要多少钱', '张亮麻辣烫创始人和杨国福', '张亮麻辣烫官网', '张亮麻辣烫老板叫什么', '张亮麻辣烫百度百科', '张亮麻辣烫什么梗']
zixiamen	['紫霞门', '字下面的横线怎么打', '兹下面一个子是什么字', '紫霞秘籍', '自下面一个木', '紫霞秘籍被谁偷了', '字下面怎么加横线', '紫霞门 望京', '字下面怎么加点', '字下面的红色波浪线怎么去掉']
金草帽炭火烤肉店	['金草帽炭火烤肉', '金草帽炭火烤肉(东五条路附近)怎么样', '金草帽炭火烤肉怎么样']
Barsak	['bars是什么意思', 'bars疗愈骗局', 'barsh', 'bar是什么意思', 'bars疗愈', 'barstow', 'barsh手表', 'barstool', 'bar是什么单位', 'bershka']
坦坦大炉望京店1	['坦坦大炉望京店', '坦坦大炉望京店怎么走', '坦坦大炉望京店 团购', '坦坦大炉望京店价格', '坦坦大炉望京烤肉店', '坦坦大炉望京店坐什么车', '坦坦大炉望京电话']
cafebene	['cafe杯子']
zhangshifu	['掌事', '章士钊', '张士诚', '张世豪', '张氏帅府', '嶂石岩', '张世', '张士平', '张士豪', '长史']
kaximu	['卡西欧', '卡西欧官网', '卡西欧手表', '卡西欧手表怎么调时间', '卡西莫多', '卡西利亚斯', '卡西欧黑金', '卡西', '卡希尔', '卡西尼']
MINGTAIYU1	['明太鱼', '明太鱼干的做法大全', '明太鱼炖豆腐', '明太鱼汤', '明太鱼干', '明太鱼是什么鱼', '明太鱼的做法', '明太鱼是海鱼吗', '明太鱼热量', '明太鱼和鳕鱼的区别']
裕食坊私家湘菜	['裕食坊私家湘菜怎么样', '裕食坊私家湘菜保利店']
MAZHA-JIUWU	['蚂蚱就是蝗虫吗', '蚂蚱就是螳螂吗', '蚂蚱就是蝈蝈吗', '马扎酒屋', '蚂蚱酒的功效与禁忌', '蚂蚱酒的功效', '蚂蚱酒怎样泡', '蚂蚱酒']
RYSWJD	['蝾螈是娃娃鱼吗', '若有所悟的若是什么意思', '荣耀侍卫平板电脑怎么样', '日益盛微博', '荣耀十为什么拉不下来', '人员伤亡程度划分', '日语商务水平是几级', '人有三碗面难吃', '日语是吴语', '若有所物']
haolinju	['浩林', '号令天下', '好邻居', '号令天下手机号码测吉凶', '号令', '号令天下手机号码测吉', '郝林', '海陵岛', '好领导', '豪麟']
huohuozhuti	['火火猪', '火火烛烛的意思', '活活捉一只麻烦精']
TOMNTOMSCOFFEE1	['tomntomscoffee中文叫什么', 'tomntomscoffee(龙湖时代天街店)怎么样']
lazhuang	['辣抓', '辣庄', '哪吒', '辣庄火锅', 'lazhua什么意思', '辣庄是包贝尔开的吗', '蜡烛啊什么梗', '辣爪', '辣抓是什么意思啊', '辣庄加盟费']
Tianfujiachangcai	['天福家常菜餐馆怎么样', '天福家常菜馆(芙蓉巷店)怎么样', '天福家常菜馆怎么样', '天福家常菜馆粥·水饺城怎么样']
warawara	['哈泥娃挖挖哇']
CupOne_5G	['cupone什么意思']
maxen	['maxus', 'maxmara', 'max什么意思', 'maximum', 'max+', 'may', '玛雅', 'max怎么读', 'imac']
JinYongKTV	['金庸卡牌手游', '禁用空调的国家', '金庸卡通频道在线直播', '禁用开机启动项', '金庸客栈', '金永康', '禁用快速启动', '晋永康思思']
熔时FIRESIDE	['熔时fireside老板是谁', '熔时fireside评价', '熔时fireside加盟', '熔时fireside老板', '熔时fireside官網', '熔时fireside连锁']
马路牙子地桌烤肉	['马路牙子地桌烤肉加盟', '马路牙子地桌烤肉', '马路牙子地桌烤肉(工体店)怎么样', '马路牙子地桌烤肉望京店', '马路牙子地桌烤肉(工体店) 概况', '马路牙子地桌烤肉(工体店)商户概况', '马路牙子地桌烤肉(工体店)用户评论']
MINGTAIYU2	['明太鱼', '明太鱼干的做法大全', '明太鱼炖豆腐', '明太鱼汤', '明太鱼干', '明太鱼是什么鱼', '明太鱼的做法', '明太鱼是海鱼吗', '明太鱼热量', '明太鱼和鳕鱼的区别']
lvhezi	['铝合金', '铝合金门窗', '铝合金门', 'lv盒子', '铝合金密度', '绿河谷', '铝合金型材', '铝和氢氧化钠反应', '绿河杀手', '铝合金焊接']
TanTanDaLu	['坦坦荡荡', '坦坦大炉', '坦坦荡荡什么意思', '坦坦荡荡做人,踏踏实实做事', '探探搭讪开场白', '坦坦荡荡做人的句子', '探探打招呼第一句', '坦坦荡荡说出那六个字', '碳碳单键', '探探打招呼']
CupOne	['cupola', 'cupon', 'cupor', 'cupone', '醋泼酸尼松片是什么药', '醋泼羊头', '醋泼松尼片作用', 'cupor什么牌子', 'cupolo摩托']
四季民福wifi	['四季民福wifi密码']
shaoxiashi	['烧虾师', '少侠是什么意思', '烧虾师傅多少钱一个月', '烧下水道用什么', '烧虾师加盟连锁店', '烧虾师总部在哪里', '烧虾什么时候 放盐', '烧霞是什么意思', '烧虾是热水还是冷水', '烧下是什么病']
Wanrongxiaochu	['万榕小厨', '万荣小吃一条街在哪', '万荣笑城', '万榕小厨 望京', '万荣笑城生态窑洞住宿怎么样', '万榕小厨商户概况', '万荣小吃街在哪里', '万荣笑城窑洞生态园酒店怎么样', '万荣小吃荞麦饸饹做法', '万荣笑城家宴电话']
yiruntang	['颐润堂望京店', '颐润堂大西洋新城店', '颐润堂国风', '颐润堂正规吗', '颐润堂按摩怎么样', '颐润堂五道口 套餐', '易润堂陈皮', '益润堂怎么样']
剪艺人生－中福	['剪艺人生望京中福店', '剪艺人生望京', '剪艺人生华彩店电话', '剪艺人生理发店怎么样', '剪艺人生怎么样', '剪艺人生望京夏都店', '剪艺人生西门子', '剪艺人生将台路店', '剪艺人生现在什么价位', '剪艺人生 价格']
CUPONE	['cupola', 'cupon', 'cupor', 'cupone', '醋泼酸尼松片是什么药', '醋泼羊头', '醋泼松尼片作用', 'cupor什么牌子', 'cupolo摩托']
huangtucheng	['黄土成语', '黄土尘埃已消遁猜一肖', '皇土成语', '黄土成分', '黄土城', '黄土尘埃', '黄土成因刘东生', '黄土沉香多少钱一克', '黄土城到延庆', '黄土沉香手串价格']
hongjingyu	['红警', '红景天', '红景天的功效与作用', '红警3', '红警ol', '红警2', '红警快捷键', '红警之家', '洪金宝', '红景天胶囊']
yesido	['椰丝', '特斯拉', 'yesir', '耶稣', 'yesido翻译中文', '椰子', 'yesido中文是什么意思', 'yesiymh', '噎死', 'yesiam']
辉佐参鸡汤	['辉佐参鸡汤']
京朋串屋老店	['京朋串屋为什么那么火', '京朋串屋总店', '京朋串屋2号店', '京朋串屋(2号店)怎么样', '京朋串屋(总店)怎么样', '京朋串屋(望京地铁站店)怎么样', '京朋串屋(万寿桥店)怎么样', '京朋串屋(万寿桥店)商户概况', '京朋串屋(海淀3店)怎么样']
HanTing	['寒天', '韩天宇', '汉庭', '汉庭酒店', '汉天子', '寒天帝', '含铁高的食物', '旱天雷', '焊条', '韩甜甜唱歌视频']
wangjingxiaoyao	['望京小腰', '望京小腰是什么腰子', '望京小腰图片', '望京小腰加盟多少钱', '望京小腰总店', '望京小腰加盟', '望京小腰哪家是真的', '望京小腰做法', '望京小腰总店在哪', '望京小腰怎么样']
寂寞的豆芽	['寂寞的少妇的诱惑', '寂寞的季节', '寂寞的女人', '寂寞的反义词', '寂寞的近义词', '寂寞的意思', '寂寞的舞者 女总裁的全能兵王', '寂寞的夜', '寂寞的人伤心的歌', '寂寞的拼音']
yixuanjiaozi	['一轩饺子馆', '艺轩教育', '艺璇教你蹦迪20', '忆璇教你蹦迪全第一集', '忆璇教你蹦迪二', '一轩饺子馆丽都店', '一轩饺子丽都', '忆璇教你蹦迪15', '忆璇教你蹦迪二十六', '忆璇教你蹦迪一']
BARSAK1	['barsac', 'barsac贵腐酒', 'barsark', 'barsan', '保安人身安全条例', '保安人身安全知识培训']
Baihualin	['白桦林', '百花楼', '百花缭乱', '白桦林歌词', '白桦林景区', '白桦林溪', '白桦林明天', '白桦林吉他谱', '白桦林图片', '白桦林间']
@辉佐参鸡汤	['辉佐参鸡汤']
qihuannuanwu	['奇幻暖暖公主图片', '奇幻暖暖图片大全']
火齐潮汕砂锅粥	['火齐潮汕砂锅粥菜单', '火齐潮汕砂锅粥怎么样', '火齐潮汕砂锅粥(国贸店)怎么样', '火齐潮汕砂锅粥(木樨园店)怎么样', '火齐潮汕砂锅粥(合生汇店)怎么样', '火齐潮汕砂锅粥价目表', '火齐潮汕砂锅粥(太阳宫凯德店)怎么样', '火齐潮汕砂锅粥加盟费', '火齐潮汕砂锅粥(慈云寺店)怎么样']
sijiminfu	['四季民福', '四季民福烤鸭店', '四季民福故宫店', '四季民福烤鸭', '四季民福烤鸭店预约', '四季名店', '四季民福烤鸭店必点菜', '四季民福菜单价格表', '四季民福烤鸭多钱一只', '四季民福烤鸭店故宫店']
yunhaiyao	['云海肴', '云海玉弓缘', '云海苑', '云海玉弓缘小说', '云海玉弓缘20集国语', '云海玉弓缘小说阅读', '云海肴菜单', '云海肴创始人', '云海玉弓缘电视剧', '云海玉弓缘在线观看']
xiaoshiguangmang	['消逝光芒', '小时光漫溢芬芳', '消逝光芒glova右手', '消逝光芒2', '消失光芒2什么时候出', '小时光猫咪咖啡馆', '消失光芒怎么才能联机', '小时光猫叫音效', '小时光麻辣烫怎么样', '小时光漫步香水']
黄门老灶火锅	['黄门老灶火锅', '黄门老灶火锅官方网站', '黄门老灶火锅贵不贵', '黄门老灶火锅分店', '黄门老灶火锅(蓝靛厂店)怎么样', '黄门老灶火锅(环亚凯瑟琳广场店)怎么样', '黄门老灶火锅好吃吗', '黄门老灶火锅(仙林大学城店)怎么样', '黄门老灶火锅(奥斯卡店)怎么样', '黄门老灶火锅(石佛营店)怎么样']
友佳超市2	['友佳超市']
新天地KTV	['新天地开发商', '新天地k11', '新天地k11是什么地方', '新天地ktv价格恩施', '新天地ktv门头照', '新天地跨贸小镇', '新天地科技有限公司', '新天地客服联系方式', '新天地可以寄存行李吗', '新天地肯德基']
duolezhiri	['多乐之日', '多乐之日官网', '多乐之日蛋糕', '多乐之日加盟费多少钱', '多乐之日蛋糕订购', '多乐之日蛋糕价格表', '多乐之日招聘', '多乐之日面包', '多乐之日是哪里的品牌', '多乐之日怎么样']
剪艺人生-夏都	['剪艺人生望京中福店', '剪艺人生望京', '剪艺人生华彩店电话', '剪艺人生理发店怎么样', '剪艺人生怎么样', '剪艺人生望京夏都店', '剪艺人生西门子', '剪艺人生将台路店', '剪艺人生现在什么价位', '剪艺人生 价格']
pangzilongxia5	['胖子龙虾', '胖子龙虾马家堡店', '胖子龙虾宋家庄店', '胖子龙虾石景山店电话', '胖子龙虾望京店', '胖子龙虾石景山店', '胖子龙虾万丰路店', '胖子龙虾料', '胖子龙虾海鲜烧烤加盟', '胖子龙虾佐料']
MrPIZZA	['mrpizza', 'mrpizza是什么品牌', 'mrpizza官网', 'mrpizza和必胜客', 'mrpizza加盟费多少钱', 'mrpizza是哪里的', 'mrpizza好吃吗', 'mrpizza加盟费', 'mrpizza投诉电话', 'mrpizza菜单及价格']
kangyunyangsheng	['康云养生堂', '康韵养生会馆正规吗', '康韵养生会馆十里河', '康韵养生会馆 概况', '康韵养生会所怎么样', '康韵养生会馆 评论', '康韵养生会所 望京']
多乐之日望京SOHO店	['多乐之日望京soho哪个面包好吃']
一个叫川的地方	['一个叫川的地方北京', '一个叫川的地方官网', '一个叫川的地方南昌', '一个叫川的地方谁开的', '一个叫川的地方餐厅', '一个叫川的地方 概况', '一个叫川的地方68折活动怎么算的']
路边烤牛肉	['路边烤鸭为什么这么便宜', '路边烤串都有啥', '路边烤鸡投资多少', '路边烤鸡架挣钱吗', '路边烤串图片', '路边烤鸡', '路边烤鸡的做法视频', '路边烤肉是什么肉', '路边烤鸭腿鸡腿', '路边烤串致癌']
zhuluchalou	['逐鹿茶楼学院路店', '逐鹿茶楼', '逐鹿茶楼西直门店', '逐鹿茶楼望京', '逐鹿茶楼知春路店', '逐鹿茶楼明光桥店', '逐鹿茶楼路六道口', '逐鹿茶楼贵足会正规吗', '逐鹿茶楼知春路']
HuoLuHuo	['火炉火', '火炉火自助', '火鹿灬念什么', '火炉火加盟费', '火炉火自助是随便点吗', '火炉火南瓜粥的做法', '火炉火烤肉', '活芦荟可以直接涂脸吗', '火炉火菜单', '火炉火自助多少钱']
TOMNTOMSCOFFEE	['tomntomscoffee中文叫什么', 'tomntomscoffee(龙湖时代天街店)怎么样']
WARAWARA	['哈泥娃挖挖哇']
