qiaobamei	['朴灿烈', '乔巴姆装甲', '朴宝英', '朴宝剑', '乔巴姆复合装甲', '乔巴帽子上的尺玉是什么意思', '乔巴萌图', '乔巴帽子', '乔巴姆', '乔巴名言']
@机场巴士	['机场大巴时刻表', '机场大巴', '机场停车多少钱一天', '机场托运行李怎么收费', '机场托运行李规定', '机场t1t2t3是什么意思', '机场线首末车时间', '机场安检员工资待遇', '机场大巴路线', '机场地勤是做什么的']
Bankcomm	['bankcomm.com', 'bank code什么意思']
TangGong	['唐功红', '唐宫', '唐宫燕', '汤沟', '唐宫美人天下', '唐宫仕女图', '唐狗', '唐功红七窍流血视频', '唐宫原著', '唐宫海鲜舫']
shenmimei	['神秘莫测', '神秘马戏团', '神秘妈眯从天降免费阅读', '神秘面具男', '神秘妈妈从天降全文免费阅读', '神秘墨少甜娇妻', '神秘妈眯从天降免费阅读无广告', '神秘面具男是谁', '神秘面具男潜入木叶召唤九尾']
城市之光6	['城市之光', '城市之窗', '城市之星', '城市之间', '城市之家', '城市之音', '城市之心', '城市之光东望', '城市之声', '城市之星物流单号查询']
chanzuimao	['馋嘴猫', '馋嘴猫加盟', '馋嘴猫零食加盟', '馋嘴猫图片', '馋嘴喵喵 西瓜视频', '馋嘴喵喵最新视频', '馋嘴麻辣烫', '馋嘴猫串吧', '馋嘴猫串串香', '馋嘴麻辣烫加盟费']
lanzhoulamian	['兰州拉面', '兰州拉面菜单', '兰州拉面的做法', '兰州拉面是哪个民族', '兰州拉面汤料配方单', '兰州拉面图片', '兰州拉面排行榜', '兰州拉面为什么不让喝酒', '兰州拉面热量', '兰州拉面的面怎么和面']
HUAZHU-Hanting	['华住汉庭酒店wifi密码', '华住汉庭', '华住汉庭酒店', '华住汉庭官网', '华住汉庭宁波', '华住汉庭酒店数据泄漏', '华住汉庭wifi密码认证', '华住汉庭wifi密码', '华住汉庭索菲亚', '华住汉庭的密码是什么']
yuzhiguang	['预制管桩', '欲之寡欢白度云', '预制管桩验收规范标准', '玉之光', '玉之光整形美容', '预制管桩施工控制要点', '宇之光大功率电霸', '宇之光', '预制管桩价格']
HUAZHU_Hanting	['华住汉庭酒店wifi密码', '华住汉庭', '华住汉庭酒店', '华住汉庭官网', '华住汉庭宁波', '华住汉庭酒店数据泄漏', '华住汉庭wifi密码认证', '华住汉庭wifi密码', '华住汉庭索菲亚', '华住汉庭的密码是什么']
wangsteak	['往steam平台发游戏']
xespy	['xess', '学而思', '形而上学', '学而思网校', '测速', 'sex', '学而思网校怎么样', '秀儿是什么意思', '学而思电话']
nanmensijishuanrou	['南门四季涮肉', '南门四季涮肉亚运村店', '南门四季涮肉左家庄店', '南门四季涮肉怎么样', '南门四季涮肉(芍药居北里店)怎么样', '南门四季涮肉(五棵松店)怎么样', '南门四季涮肉 立水桥', '南门四季涮肉五棵松店', '南门四季涮肉(亚运村店)商户概况']
huajiayiyuan	['花家怡园', '花家怡园四合院', '花家怡园菜单', '花家怡园东直门店', '花家怡园圆明园店', '花家怡园惠新店', '花家怡园融科店', '花家怡园金融街店', '花家怡园清华西路店', '花家怡园四季青店']
又一湘二楼	['又一湘 惠新东', '又一湘望京店', '又一湘望京']
chuanshifengge	['串式风筝', '串式风筝图片大全', '串式风筝简笔画', '传世风景二手房出售', '传世封号王爵升级表', '串式风车怎么安装', '穿石风图片', '串式风车怎么安装图解', '传世风宝真的治痛风吗', '传世风景幼儿园怎么样']
HUAZHU-Hanting.	['华住汉庭酒店wifi密码', '华住汉庭', '华住汉庭酒店', '华住汉庭官网', '华住汉庭宁波', '华住汉庭酒店数据泄漏', '华住汉庭wifi密码认证', '华住汉庭索菲亚', '华住汉庭的密码是什么', '华住汉庭电话是多少']
PizzaHut	['pizza火币', 'pizza盒子能进微波炉', 'pizza汉语意思是什么', 'pizza烘烤温度时间', 'pizza盒子设计这样用', 'pizza好消化吗', 'pizza汉语', 'pizza烘焙', 'pizza黄游', 'pizza黄游戏']
hongxizu	['红袖添香', '洪秀全', '红细胞', '洪秀柱', '虹吸', '红星美凯龙', '红星闪耀评价', '红袖', '红星照耀中国', '红心火龙果']
tuojiangxiaozhen	['沱江小镇', '沱江小镇对外经贸大学', '沱江小镇餐饮管理有限公司', '沱江小镇(安贞店)商户概况']
动感易带网吧	['动感易带网吧怎么样', '动感易带网咖怎么样']
sinopec	['sinopec', 'sinopec是什么意思', 'sinopay', 'sinopac', 'sinopecsales.co m', 'sinopec全称', 'sinope', 'sinoped', 'sinophile', 'sinoppe']
muwushaokao	['木屋烧烤', '木屋烧烤菜单', '木屋烧烤创始人', '木屋烧烤加盟费多少', '木屋烧烤官网', '木屋烧烤营业时间', '木屋烧烤老板', '木屋烧烤店', '木屋烧烤几点海鲜半价']
伊藤洋华堂亚运村店	['伊藤洋华堂亚运村店', '伊藤洋华堂亚运村营业时间', '伊藤洋华堂亚运村店退换货', '伊藤洋华堂亚运村点1楼新开化妆品什么牌子', '伊藤洋华堂亚运村店电话']
Yitel	['倚天屠龙记', '以太坊', '一胎两宝老婆大人别想逃', '一天', '伊藤润二', '一条小团团', '一天喝8杯奶茶', '一胎俩宝 老婆大人别想逃', '一胎双宝总裁大人夜夜欢', '一条狗的使命2']
Atour	['atom', '阿童木', 'atop', 'atmos', 'atos', 'atomy', 'atoi', 'auto', 'atom加速器']
@秦风渝味	['秦风兵王', '秦风一世兵王', '秦风小说免费全文阅读', '秦风网', '秦风无依原文', '秦风小说', '秦风兵王小说', '秦风兵王主角的小说', '秦风蒹葭全文注拼音']
城市之光3	['城市之光', '城市之窗', '城市之星', '城市之间', '城市之家', '城市之音', '城市之心', '城市之光东望', '城市之声', '城市之星物流单号查询']
bengeshousi	['本格寿司', '本格寿司 北京', '本格寿司 杭州']
bibichi	['bibicar', '笔笔攒', '笔笔攒怎么解冻', '笔笔攒是什么意思', '笔笔攒怎么取消', '比比攒什么意思', '笔笔攒的钱怎么取出来', '笔笔攒取出的钱在哪里', '笔笔攒怎么取出来', '笔笔攒冻结金额能取吗']
@茶花妹子过桥米线	['茶花妹子过桥米线', '茶花妹子过桥米线怎么样', '茶花妹子过桥米线地安门1店怎么样', '茶花妹子过桥米线(地安门1店)怎么样', '茶花妹子过桥米线 北京']
Starbucks	['starbucks', '星巴克', '抖音那个starbuc']
西贝莜面村	['西贝莜面村', '西贝莜面村12个必点菜', '西贝莜面村怎么念', '西贝莜面村让加盟吗', '西贝莜面加盟费', '西贝莜面事件', '西贝莜面村创始人', '西贝莜面村菜品图片', '西贝莜面村400电话号码', '西贝莜面里什么菜好吃']
五指生亚运村店	['五指生亚运村店', '五指生亚运村店电话', '五指生亚运村店图片', '五指生亚运村营业时间', '五指生亚运村店价目表', '五指生亚运村店 赵总监', '五指生亚运村店女技师', '五指生亚运村店修脚师']
城市之光5	['城市之光', '城市之窗', '城市之星', '城市之间', '城市之家', '城市之音', '城市之心', '城市之光东望', '城市之声', '城市之星物流单号查询']
便宜坊03	['便宜坊烤鸭', '便宜坊烤鸭多少钱一只', '便宜坊怎么读', '便宜坊烤鸭和全聚德烤鸭的区别', '便宜坊烤鸭店', '便宜坊总店', '便宜坊电话', '便宜坊集团', '济南便宜坊', '便宜坊主厨']
dechuanjia	['德川家康', '德川家', '德川家光', '德川吉宗', '德川家日料', '德川家康人物关系图', '德川家茂', '德川家康全集在线阅读', '德川家族', '德川家康名言']
4008190099	['4008190099']
super8	['super', 'super junior', 'superior', 'supermarket', 'superb', 'superman', 'superm', 'supervision', 'superficial', 'superhero']
diguashequ	['地瓜什么时候成熟', '地瓜生芽还能吃吗', '地瓜社区', '地瓜什么时候种', '地瓜什么时候翻秧', '地瓜什么时候传入中国', '地瓜生吃有什么好处', '地瓜生长期多少天', '地瓜生牙子能吃吗', '地瓜社区官网']
交通银行信用卡	['交通银行信用卡电话', '交通银行', '交通银行信用卡中心', '交通银行信用卡申请', '交通银行电话', '交通银行信用卡app', '交通银行信用卡额度', '交通银行信用卡客服', '交通银行信用卡注销', '交通银行信用卡怎么样']
shigehuntun	['十个馄饨差不多多少克', '十个馄饨的热量', '十个馄饨', '十个馄饨门头图片', '十个馄饨的热量多少']
味多美安慧东里店	['味多美安慧东里店']
mengjizhoupu	['孟记粥铺']
