N27th	['n270', 'n270cpu', 'n27火车模型', 'n270 软路由', 'n27路', 'n270群晖', 'n270功耗', 'n27204', 'n270 j1800', '女27岁掉头发怎么回事']
32bar	['32bit', '32步广场舞', '32bit是什么意思', '32寸', '32bps观看', '32b飞机', '32bit data transfer', '32步蹦迪摇']
pinkbaby	['pink包', 'pinkbag怎么读音', 'pink包什么牌子', 'pink包什么档次', 'pink巴厘岛粉可乐', 'pink包包官网', 'pink豹', 'pink百度百科']
shunshun	['顺势而为', '顺时针', '瞬时速度', '顺水推舟', '顺手牵羊', '顺时针是什么方向', '顺势', '顺势疗法', '顺顺留学', '顺顺']
xiachixiashuan	['虾吃虾涮', '虾吃虾涮的做法', '虾吃虾涮加盟多少钱', '虾吃虾涮加盟', '虾吃虾涮虾火锅', '虾吃虾涮图片', '虾吃虾涮怎么样', '虾吃虾涮菜单', '虾吃虾涮地址', '虾吃虾涮虾火锅加盟费多少钱']
jazzya	['jazz是什么舞种', 'jazz是什么意思中文翻译', 'jazz舞', 'jazz funk是什么舞种', 'jazzcat舞蹈考级视频', 'jazz rap', 'jazz怎么读', 'jazz分类']
CHAOGuest	['炒股二级市场是什么', '炒股etf是什么意思', '炒股二八定律', '炒股二十年的体会']
3AM-5G	['3am美发', '3am美发创始人介绍', '3am美发简介', '3am什么意思', '3am美发价格', '3am智超介绍', '3am理发店', '3am歌曲', '3am大东微博', '3am是什么']
elephant1	['elephant', 'elephant 怎么读', 'elephant什么意思思', 'elephant是什么意思中文', 'elephant儿歌', 'elephant是什么意思', 'elephant bird', 'elephant man', 'elephant in the room', 'elephant音标']
shunshun2	['顺水推舟', '顺顺利利', '顺顺留学', '顺水人情', '顺顺', '顺水鱼馆', '顺遂', '顺水速度和逆水速度的公式', '顺顺电影', '顺数']
hanjimmy	['韩纪面膜', '韩纪面膜怎么样', '韩纪面膜安全吗', '韩记面膜', '韩纪面膜小猪酸奶', '韩继明', '焊机脉冲是什么意思', '焊机模块', '焊机mlg什么意思', '焊机mma和tig']
TOKYOJING	['tokyo简写', 'tokyo几好看']
Jasmine	['jasmine', 'jasmin', 'jasmine英文名', 'jasmine flower', 'jasmine怎么读', 'jasmine什么意思中文', 'jasmine和张艺兴', 'jasmina', 'jasmine英文名禁忌', 'jasmine即刻电音']
MARTINI	['martin', 'martial', 'martini', 'martina', 'martine', 'martial arts', 'martin什么意思中文', 'martins', 'martin luther king', 'matrix']
InterContinental	['intercontinental', 'intercontinental洲际酒店', 'intercontinental上海', 'intercontinental hotel', 'intercontinental hotel上海', 'intercontinental怎么读', 'intercontinental长沙', 'intercontinental广州', 'intercontinental成都']
INSTYLE-2	['instyle造型', 'instyle造型价目表', 'instyle中文是什么意思', 'instyle是什么牌子', 'instyle创始人', 'instyle造型官网', 'instyle优家画报', 'instyle杂志', 'instyle美发创始人', 'instyle是什么意思']
云川台球三里屯店	['云川台球三里屯店']
walahuoguo	['蛙辣火锅', '蛙辣火锅图片']
1001night	['1001nights', '1001nights天野喜孝', '1001night']
HomeInns	['homeinn', 'homeinn什么意思', 'homeins']
BRACKET	['bracket', 'bracket是什么意思中文翻译', 'bracken', 'brackish', 'bracket什么意思', 'brackla', 'bracke', 'tracker', 'brake', 'bracket coffee']
Moonshine	['moonshine', 'moon是什么意思', 'moon是谁', 'moonshine是什么意思', 'moon是什么意思中文', 'moon是什么意思中文翻译', 'moon是什么牌子', 'moonshine conjecture', 'moonshine valley', 'moonshine是什么牌子']
sanfulong	['三福龙景 福清', '三福logo', '三福龙景最新房价', '三福龙廷多少一平方', '三福龙景龙廷房价', '三福龙景初中划片', '三福龙景沙县小吃', '三福楼', '三辅龙拳之十步拳', '三福龙景龙廷二手房']
小七君私房菜	['小七君私房菜']
caixin	['蔡徐坤', '菜心', '蔡徐坤微博', '蔡徐坤生日', '蔡徐坤图片', '彩霞', '菜系']
mizuki	['米祖', 'mizuno', '迷醉', '弥足珍贵', 'mizuho', '咪唑', '迷组词', '密组词', '弥足', '蜜汁炖鱿鱼']
rongshangzaoxing_5G	['融尚造型', '融尚造型(工体北路一店)怎么样', '融尚造型(工体北路一店)', '融尚造型(工体北路一店) 评论', '融尚造型(工体北路二店)怎么样']
YJXCGY	['艳决乡村', '眼睑下垂', '月经血呈黑色', '异界小厨仙', '眼角下垂', '夜间行车开什么灯', '义井小吃街搬哪了', '眼睑下垂图片', '眼角下垂面相', '豫剧下陈州全场']
HaiDiLaoHuoGuo	['海底捞火锅', '海底捞火锅加盟', '海底捞火锅价格表', '海底捞火锅底料', '海底捞火锅加盟费多少', '海底捞火锅怎么吃', '海底捞火锅成立于哪一年', '海底捞火锅底料怎么调', '海底捞火锅底料哪个好吃', '海底捞火锅加盟费吗']
Starbucks	['starbucks', '星巴克', '抖音那个starbuc']
Toybox	['toybox', '头孢', 'toyboy是什么牌子的', 'toybear是什么意思', 'toybus是什么意思', 'toybear怎么读', '头孢地尼分散片', 'toybiz', 'toyboy包包正品多少钱', 'toybike']
NiaoTun	['尿酮体', '尿痛', '尿糖', '尿酮', '鸟头', '尿酮体阳性', '尿糖高', '尿糖阳性', '尿糖4+', '尿疼']
shijiajingpin	['世家精品酒店', '世嘉景品质量如何', '世家精品酒店怎么样', '世嘉景品 fate rider', '世嘉景品为何如此便宜']
hongyitang_1f	['弘医堂中医院', '弘医堂', '弘医堂中医院怎么样', '弘医堂夏梦', '弘医堂中医院电话', '弘医堂耳鼻喉研究院怎么样', '宏医堂', '宏易堂', '弘医堂 温仕德', '洪姨糖水可以加盟吗']
super8	['super', 'super junior', 'superior', 'supermarket', 'superb', 'superman', 'superm', 'supervision', 'superficial', 'superhero']
CMCC-WEB	['cmccweb是什么网络', 'cmccweb收费吗', 'cmccweb', 'cmccweb怎么免费连接', 'cmccweb免费账号密码', 'cmccweb登录界面', 'cmccweb怎么连接', 'cmcc网络怎么连接', 'cmcc网络', 'cmcc无线网']
yanweidie	['燕尾蝶', '燕尾定理', '燕尾钉', '燕尾蝶歌词', '严卫东', '烟味多久能散', '燕尾蝶图片', '烟味对孕妇有什么危害', '燕尾钉规格尺寸', '燕尾蝶的寓意']
中国联通-D-one	['中国联通董事长是谁', '中国联通东方财富', '中国联通董事长级别', '中国联通都有什么套餐', '中国联通东圃营业厅', '中国联通抖音卡套餐', '中国联通东海缤纷店', '中国联通董事长年薪', '中国联通东莞营业厅', '中国联通都有哪些号段']
xiaohongpaoS	['小红袍', '小红袍龙虾馆', '小红袍火锅', '小红袍茶叶', '小红袍花椒', '小红爬一层楼要用12秒', '小红袍龙虾', '小红拍皮球看图写话', '小红袍和大红袍的区别', '小红袍火锅王府中环']
hooters1	['hooters', 'hooters餐厅', 'hooters猫头鹰餐厅', 'hooters是什么意思', 'shooter', 'hooters陆家嘴', 'hooters餐厅营业状况', 'hooter是什么意思啊', 'gun shooter', 'cf吉林一区shooter']
shuilintianyue	['水临天玥', '水临天玥歺牌价格', '水临天玥商户概况', '水林天月酒吧 东大桥']
hongyitang_2f	['弘医堂中医院', '弘医堂', '弘医堂中医院怎么样', '弘医堂夏梦', '弘医堂中医院电话', '弘医堂耳鼻喉研究院怎么样', '宏医堂', '宏易堂', '弘医堂 温仕德', '洪姨糖水可以加盟吗']
SIR.TEEN	['sirteen酒吧', 'sir.teen', 'sirteen散客门票', 'sirtex', 'sirteen翻译中文', 'sirte', 'sirteen酒吧门票', 'sirteen酒单', 'sirtec', 'sirteen散台多少钱']
MCD-ChinaNet	['mcd-chinanet']
D-one	['dota2', '斗罗大陆', '抖音', '东方财富网', '斗罗大陆4终极斗罗', 'dota', 'down', 'doctor', 'doll', "don't"]
lantern	['兰特', 'lantern读音', 'lantern festival', '兰特汇率', 'lanter官网']
xiaogechuanchuan	['小哥串串香(三里屯店)怎么样', '小哥串串香(银河SOHO店)怎么样', '小哥串串香(回龙观店)怎么样', '小哥串串香(金源店)怎么样', '小哥串串香(银河SOHO店)']
carmen	['carmax', 'carmel', 'carmine', 'carman', 'carmex', 'carol', 'garmin', 'carmina', 'carmen的意思']
dk1308	['dk13发动机正时图解', 'dk138设置新密码', 'dk1306发动机正时图', 'dk138门禁改密码', 'dk138编程密码', '贷款13万三年月还多少', '贷款130万25年怎么', '贷款130万利息是多少', '东康13升和福康哪个好', '打开137端口']
dipingxian	['地平线', '地平线4', '地平线摩托车', '地平线3', '地平线零之曙光', '地平线公司', '地平线4手机版下载', '地平线英文', '地平线黎明时分', '地平线武器箱']
拿铁酒吧1	['拿铁酒吧老板背景', '拿铁酒吧义乌', '拿铁酒吧舞曲']
Ginger	['ginger', 'gingerbread', '工商银行', 'ginger怎么读音', '宫崎骏', '宫外孕', 'ginger ale', 'ginger什么意思', 'ginga', 'gingerly']
elephant	['elephant', 'elephant 怎么读', 'elephant什么意思思', 'elephant儿歌', 'elephant是什么意思', 'elephant bird', 'elephant是什么意思中文', 'elephant in the room', 'elephant音标', 'elephant seal']
niaotun	['尿酮体', '尿痛', '尿糖', '尿酮', '鸟头', '尿酮体阳性', '尿糖高', '尿糖阳性', '尿糖4+', '尿疼']
rijin	['日剧', '日记', '日剧网', '日记格式', '日记200', '日记100字大全', '日久生情', '日进斗金', '日记500字', '日加一笔']
toastbar	['toast病因分型']
didiao	['滴滴新规则公示', '滴滴', '滴滴客服', '低调组合', '滴滴代驾', '敌敌畏', '滴滴出行', '滴滴被罚550万元', '滴滴打车', '低调看']
LaoTie	['老铁', '老头', '老田', '老太太', '老头乐', '老态龙钟', '老太太garanny', '老铁是什么意思', '老头鱼', '老唐']
shangbangdaisi	['上邦戴斯精品酒店', '上邦戴斯酒店网评', '上邦戴斯', '上邦戴斯酒店', '上邦戴斯酒店集团', '上邦戴斯酒店管理集团怎么样', '上邦戴斯酒店招聘', '上邦戴斯温泉酒店', '上邦戴斯酒店北京', '上邦戴斯酒店管理有限公司']
马路牙子地桌烤肉5G	['马路牙子地桌烤肉加盟', '望京马路牙子地桌烤肉', '马路牙子地桌烤肉(工体店)怎么样', '马路牙子地桌烤肉(工体店) 概况', '马路牙子地桌烤肉(工体店)商户概况', '马路牙子地桌烤肉(工体店)用户评论', '马路牙子地桌烤肉密码']
Playhouse	['playhouse', 'playhouse酒吧', 'playhouse什么意思', 'playhouse成都', 'playhouse酒吧创始人', 'playhouse怎么读', 'play后面什么时候加the', 'playhouse长沙', 'playhouse成都价格']
中国联通-Lugas	['中国联通鲁谷营业厅', '中国联通芦沟桥菅业部电话', '中国联通鲁谷附近营业厅', '中国联通卢沟桥营业厅电话', '中国联通鲁古营业厅坐公交', '中国联通卢沟桥营业厅地铁哪站下', '中国联通卢沟桥分局怎么样']
DLOUNGE	['dlou能组成什么单词']
世家精品酒店	['世家精品酒店', '世家精品酒店怎么样', '黔酱世家精品', '世家精品酒店(垦利店)怎么样', '世家精品酒店电话', '世家精品酒店团结湖', '世家精品酒店预订', '世家精品酒店招聘']
xiaochunrihe	['小春日', '小春日和', '小春日和露丝猫', '小春日和 露娜猫微盘', '小春日和露丝猫百度云', '小春日和露丝猫全文阅读', '小春日和by露丝猫', '小春日和露娜猫txt百度云', '小春日和百度云盘']
haidilaoPOS	['海底捞排号', '海底捞啤酒', '海底捞排队取号微信', '海底捞配料怎么调', '海底捞排号过了怎么办', '海底捞平均每人多少钱', '海底捞排队', '海底捞排号怎么排', '海底捞啤酒多少钱一瓶', '海底捞派钱']
velvet	['velvet', 'velvety', 'velveteen', 'velvet意思', 'red velvet', 'velvet是什么牌子口红', 'velvety怎么读', 'velva', 'velvet underground', 'velvet怎么读音']
Knight魔术酒吧	['knight魔术酒吧']
24小时自助图书馆	['24小时自助图书馆书籍多吗', '24小时自助图书馆', '24小时自助图书馆怎么使用', '24小时自助图书机', '24小时自助图书馆加盟', '24小时自助图书馆费用', '24小时自助图书馆退卡', '24小时自助图书馆(大东门街分馆)怎么样', '24小时自助图书馆 评论']
LianJia	['链家', '链家网', '链接', '脸基尼', '连襟', '脸颊', '联机游戏', '连江前天发生一起车祸', '廉晶雅', '练俊杰']
republic	['republic', 'republic of korea', 'republic什么意思', 'republic of china什么意思', 'republic of game', 'republication', 'republic怎么读', 'republic of singapore', 'republic mexican银币', 'republic of indonesia']
huangmen	['皇马', '黄明昊', '黄明', '黄焖鸡', '黄玫瑰', '黄梅戏', '皇马0-1不敌热刺', '荒木经惟', '黄焖鸡做法', '黄梦莹']
Scandal	['scandalous', 'scandal and liber', 'scanf', 'sandal', 'scandalize', 'scandium', 'scandi', 'scandic酒店 挪威', 'scandisk是什么意思']
XLKHG	['新纶科技', '小龙坎', '夏洛克', '西陇科学', '邪龙狂兵', '欣龙控股', '修炼狂潮', '小两口', '夏洛克福尔摩斯', '迅雷看看']
BOTTEGA	['bottega是什么牌子', 'botter', 'bottle', 'bottega官网', 'bottom', 'botten', 'bottega veneta', 'bottero', 'bottega鞋', 'bottega香槟']
DK1308	['dk13发动机正时图解', 'dk138设置新密码', 'dk1306发动机正时图', 'dk138门禁改密码', 'dk138编程密码', '贷款13万三年月还多少', '贷款130万25年怎么', '贷款130万利息是多少', '东康13升和福康哪个好', '打开137端口']
jinguixiaoshancheng	['金簋小山城', '金簋小山城牛蛙', '金簋小山城 春秀路', '金簋小山城分店电话', '金簋小山城(亚运村店)怎么样', '金簋小山城(亚运村店)', '金簋小山城(南湖东路店)怎么样', '金簋小山城(簋街一店)怎么样', '金簋小山城加盟费多少', '金簋小山城(秦皇大街店)怎么样']
zhanhouse	['战吼', '战后之战', '战吼萨', '战后创伤综合症', '战后日本', '战后余温', '战后叙利亚', '战吼萨卡组最新2019', '战猴']
bodhi	['body', 'body lotion', 'bodies', 'body怎么读 发音', '波多黎各', 'body wash是什么意思中文翻译', 'body lotion什么意思', 'body pump是什么运动', 'body soap', 'body lotion是什么意思中文翻译']
3AM-B1	['3am美发', '3am美发创始人介绍', '3am美发简介', '3am什么意思', '3am美发价格', '3am智超介绍', '3am理发店', '3am歌曲', '3am大东微博', '3am是什么']
Cargo	['scar', 'care', 'carry', 'carrot', 'career', 'vcard', 'cartier', 'cartoon', 'cart', 'carpet']
R-kiss	['rkid是什么意思', '锐科ipg区别', 'raid卡inactive', 'cherki', 'zorki', 'aarki']
ONETHIRD	['one third酒吧']
njdpd	['南京大学', '牛津大学', '南京大学金陵学院', '南京地铁贴吧', '南京大牌档', '南京地图', '你的名字', '南京地铁线路图']
LetsBURGERplus	['letsburgerplus 菜单', 'letsburgerplus 蓝港', 'letsburgerplus怎么读', 'letsburgerplus是加盟店吗', 'letsburgerplus网红', 'letsburgerplus价格', 'letsburgerplus天津', 'letsburgerplus 上海']
IBIZA-B3	['ibiza绝地求生', 'ibiza 西班牙', 'ibiza是谁', 'ibiza liquid', 'ibiza微博', 'ibiza绝地求生 哪国人', 'ibiza虎牙直播', 'ibiza电音节', 'ibiza绝地求生资料', 'ibiza是什么意思']
为美好相聚沸腾	['为美好相聚沸腾']
bajianchuan	['拔剑出鞘', '拔剑出鞘的意思', '拔剑出鞘的特效声音', '巴建川', '拔尖创新人才', '拔尖创新人才培养模式', '八件传说中的厨具', '巴尖串串的鲍鱼是啥', '拔尖创新人才实验班', '拔剑出东门']
tongxinge	['童心', '同性恋', '通信工程', '通心粉', '童星', '通信工程专业', '同性', '痛心疾首', '通信']
laotao	['老铁', '老头', '老田', '老太太', '老头乐', '老态龙钟', '老太太garanny', '老铁是什么意思', '老头鱼', '老唐']
yuebeixiaocheng	['粤北小城', '粤北小城法人', '粤北小城金地中心店', '粤北小城关门了', '粤北小城(三里屯世茂店)怎么样', '粤北小城世贸百货店怎么样', '粤北小城(世贸百货店)', '粤北小城·潮汕砂锅粥怎么样']
Berko-1	['berkore是什么牌子', 'berko蛋糕店']
HUAZHU-Hanting	['华住汉庭酒店wifi密码', '华住汉庭', '华住汉庭酒店', '华住汉庭官网', '华住汉庭宁波', '华住汉庭酒店数据泄漏', '华住汉庭wifi密码认证', '华住汉庭wifi密码', '华住汉庭索菲亚', '华住汉庭的密码是什么']
XDHDSJ	['鞋带蝴蝶结的打法', '线雕后的注意事项', '宣德皇帝', '小调和大调的区别', '吸毒后多久检测不出来', '咸蛋黄豆腐', '雪地悍刀行小说免费阅读', '鞋带蝴蝶结', '咸蛋黄豆腐的做法', '现代和当代的区别']
HighTown	['highton', 'high同义词', 'high同音词', 'high同义词组', 'high同音异形词', 'high同音词怎么写']
三公潮汕牛肉火锅1	['三公潮汕牛肉火锅三里屯店', '三公潮汕牛肉火锅三里屯']
GoodBait	['goodbay', 'goodbay是什么意思', 'goodbay舞蹈视频', 'goodbay什么意思中文', 'goodbay我的爱人再见', 'good拜英语怎么写', 'goodbay舞蹈歌曲', 'goodbag英文什么意思', 'goodbay怎么读音', 'goodbay英语什么意思']
shunshun_5G	['顺顺溜溜的意思', '顺顺留学', '顺顺利利图片', '顺顺利利的数字红包', '顺顺利利', '顺顺丰快递单号查询', '顺顺', '顺顺利利的祝福语', '顺顺顺', '顺顺当当意思']
大龙燚火锅	['大龙燿怎么读', '大龙燚火锅', '小龙坎', '大龙燿官网', '大龙燚加盟', '大龙燚菜单', '大龙燚老板', '大龙燚加盟费', '大龙燿小龙坎哪个好吃', '大龙燚创始人']
HUAXING_GUEST	['花姓孤儿全文阅读']
ANCHOR-0	['anchor是什么意思中文', 'anchorage', 'anchor奶粉怎么样', 'anchorage是哪个城市', 'news anchor', 'anchor奶粉', 'the anchor', 'anchor自行车', 'anchor point', 'anchoret']
HEYTEA	['heytea', 'heytea喜茶 官网', 'heytea是什么意思', '耗儿鱼图片', 'heytea喜茶加盟吗', 'heytea喜茶', 'heytea喜茶加盟费大概多少', 'heytea怎么读', '海尔一拖三中央空调', '海尔一拖一风管机报e5']
FOURACE	['foura公司', '否然', 'foura广告公司要求', 'foura的logo']
RestaurantY	['restaurant', 'restaurant怎么读', 'restaurant的中文意思是什么', 'restaurant怎么读英语', 'restaurant 是什么意思', 'restaurant是什么意思中文', 'restaurant是什么意思中文翻译', 'restaurant怎么读音发音', 'restaurant的音标', 'restaurant的中文']
Shuilintianyue	['水临天玥', '水临天玥歺牌价格', '水临天玥商户概况', '水林天月酒吧 东大桥']
SWING58	['swing什么意思', 'swings', 'swing怎么读', 'swing dance', 'swing过去式', 'swing by', 'swimming', 'swing公司', 'swing jazz']
Vplus	['vpls', 'vplayer', 'vplus', 'volte', 'volvo', 'volte基本通话费', 'vplus酒吧', 'vpls技术', 'volume', 'vp浏览器手机版下载']
instyle	['instyle', 'instyle造型', 'instyle中文是什么意思', 'instyle造型价目表', 'instyle是什么牌子', 'instructor', 'instyle创始人', 'instyle是什么意思', 'instyle优家画报', 'instruction']
hongyitang_n2	['弘医堂中医院', '弘医堂', '弘医堂中医院怎么样', '弘医堂夏梦', '弘医堂中医院电话', '弘医堂耳鼻喉研究院怎么样', '宏医堂', '宏易堂', '弘医堂 温仕德', '洪姨糖水可以加盟吗']
Buerjiuguan	['不二酒馆怎么样', '不二酒馆斯斯与帆']
REDREAM	['redress', 'redream', 'redress什么意思', 'regret', 'redream模拟器安卓版', 'redress number', 'redream模拟器', 'red认证', 'redrest舞蹈教学', 'redressal']
BaseFit	['basefex', 'basefx公司', 'based', 'base', 'base法则', 'base翻译', 'base复数', 'basefex下载', 'basefx好进吗', '巴瑟弗生态艺术壁材']
YingLanQuanXi	['英澜全屋定制怎么样', '樱兰全息养生馆正规吗', '樱兰全息养生馆怎么样']
INSTYLE1	['instyle', 'instyle造型', 'instyle中文是什么意思', 'instyle造型价目表', 'instyle是什么牌子', 'instyle是什么意思', 'instyle创始人', 'instyle造型官网', 'instyle优家画报', 'instyle美发创始人']
COSTA2	['costco', 'costa', 'costs', 'costly', 'costco超市', 'costa咖啡', 'cos太乙真人', 'cost过去式', 'custom', 'cost用法']
Anchor	['鹌鹑', '鹌鹑蛋', '氨茶碱', '暗疮', 'anchorage', 'anchovy', '安超os', '鹌鹑蛋的做法', '按察使', '暗娼']
pzoom	['pzoz', 'pzone', 'pzo转换表', 'pzoz是什么牌子', 'p总', 'python中os', '疱疹呕吐', 'ps中overlay什么意思', '品致欧乐系统门窗', '普宙o2与大疆air']
马路牙子地桌烤肉	['马路牙子地桌烤肉加盟', '马路牙子地桌烤肉', '马路牙子地桌烤肉(工体店)怎么样', '马路牙子地桌烤肉望京店', '马路牙子地桌烤肉(工体店) 概况', '马路牙子地桌烤肉(工体店)商户概况', '马路牙子地桌烤肉(工体店)用户评论']
pintec	['拼t', 'pinterest.com', '姘头', '拼图', '品脱', 'paint', '拼图软件', 'pints', 'pint怎么读', 'pintle']
instyle02	['instyle造型', 'instyle造型价目表', 'instyle中文是什么意思', 'instyle是什么牌子', 'instyle创始人', 'instyle造型官网', 'instyle优家画报', 'instyle杂志', 'instyle美发创始人', 'instyle是什么意思']
3am客网	['3am美发', '3am美发创始人介绍', '3am什么意思', '3am的歌曲', '3am美发简介', '3am歌词', '3am接发', '3am理发店', '3am美发价格', '3a模型']
mubei	['目标', '姆巴佩', '目不转睛', '幕布', '目不暇接', '墓碑', '钼靶', 'much', '目标管理', '目不识丁']
北京长虹医院	['北京长虹医院', '北京长虹医院怎么样', '北京长虹医院是正规医院吗', '北京长虹医疗美容医院怎么样', '北京长虹桥', '北京长虹散热器', '北京长虹医院整容好吗', '北京长虹医院是私立的还是国家的', '北京长虹医疗美容医院', '北京长虹医院可靠吗']
OneThird	['one third酒吧']
bianyifang	['便宜坊', '便宜坊烤鸭', '便宜坊烤鸭多少钱一只', '便宜坊怎么读', '便宜坊烤鸭和全聚德烤鸭的区别', '便宜反义词', '便宜坊烤鸭店', '便宜坊烤鸭店总店地址', '便宜坊烤鸭价目表', '便宜坊总店']
xiaozhang	['肖战敷眼膜现身', '肖战', '小丈夫', '肖战图片', '嚣张', '肖战微博', '小昭', '肖战 顾医生', '校长']
HUAXING	['华夏银行', '华西村', '华西医院', '花仙子', '华夏航空', '花溪谷', '华夏图腾', '华夏幸福', '华雄', '滑翔伞']
rongshangzaoxing	['融尚造型', '融尚造型(工体北路一店)怎么样', '融尚造型(工体北路一店)', '融尚造型(工体北路一店) 评论', '融尚造型(工体北路二店)怎么样']
PizzaHut	['pizza火币', 'pizza盒子能进微波炉', 'pizza汉语意思是什么', 'pizza烘烤温度时间', 'pizza盒子设计这样用', 'pizza好消化吗', 'pizza汉语', 'pizza烘焙', 'pizza黄游', 'pizza黄游戏']
WX-D-one	['万秀斗殴事件', '我想当偶像', '无锡到欧洲旅游', '无形的欧顿', '无锡迪欧咖啡', '微信的ok表情包图片', '无形的偶像包括什么', '微信的ohh', '微信的obj是什么', '网线灯偶尔亮一下']
dongfangliang	['东方联盟', '东方亮彩精密技术有限公司', '东方联盟郭盛华', '东方亮彩', '东方联盟官方网站', '东方亮彩科技有限公司', '东方亮彩怎么样', '东方量化成长灵活005616净值', '东方联盟创始人郭盛华', '东方恋觉想']
Wolfgang1	['wolfgang', 'wolfgang puck', 'wolfgang牛排', 'wolfgang是谁', 'wolfgang什么意思', 'wolfgang puck米其林', 'wolfgang puck是谁', 'wolfgang see', 'wolfgang相机包里的布', 'wolfgang wick']
TheRug	['there', 'therefore', 'therapy', 'thermo', 'there be句型', 'thermos', 'thermal', 'thereby', 'there怎么读', 'there is']
dazhangfu	['打仗', '大张伟', '大丈夫', '大张伟老婆', '大掌门', '大掌柜', '大张高铁', '大丈夫日记', '大蟑螂', '大掌门2']
shaoxiashi	['烧虾师', '少侠是什么意思', '烧虾师傅多少钱一个月', '烧下水道用什么', '烧虾师加盟连锁店', '烧虾师总部在哪里', '烧虾什么时候 放盐', '烧霞是什么意思', '烧虾是热水还是冷水', '烧下是什么病']
ifensi	['ifeng', 'ifeng凤凰', 'ifensi', 'ifeng网', 'sina', 'identity', '风直播', '蜂窝', '起风了', 'ifeng凤凰电脑版']
Caixin	['蔡徐坤', '菜心', '蔡徐坤微博', '蔡徐坤生日', '蔡徐坤图片', '彩霞', '菜系']
ShiTangZui	['石塘镇', '石塘竹海', '石塘镇游玩攻略', '食堂招女工', '石塘竹海景区', '食堂招标网', '食堂招聘', '食堂早餐食谱', '石塘在哪里', '食堂招聘洗碗工']
东方饺子王	['东方 饺子王电话号码']
aojiameishuguanjiudian	['奥加美术馆酒店电话', '奥加美术馆酒店-地面停车场怎么样', '奥加美术馆酒店为何小姐多', '奥加美术馆酒店地铁能到吗', '奥加美术馆酒店饭菜怎样?', '奥佳美术馆酒店怎么座地铁', '奥加美术馆酒店夜总会电话', '澳加美术馆酒店底下KTV叫什么', '奥加美术馆酒店(东直门外大街26号)']
sushitong	['宿世通', '苏事通', '苏轼同时代诗人有哪些', '苏氏透骨熏蒸加盟费', '苏轼同科进士有哪些', '苏轼童年里璀璨的明珠', '苏氏头像图片大全', '苏世通 私募', 'sushi桐', '苏轼头像的简笔画']
hooters2	['hooters', 'hooters餐厅', 'hooters猫头鹰餐厅', 'hooters是什么意思', 'shooter', 'hooters陆家嘴', 'hooters餐厅营业状况', 'hooter是什么意思啊', 'gun shooter', 'cf吉林一区shooter']
rampage	['rampage', 'rampant', 'rampart', 'rampant什么意思', 'rampage是什么意思', 'rampancy', 'rampage电影', 'rampal', 'rampant ascendance', 'rampage是什么牌子']
Velvet	['velvet', 'velvety', 'velveteen', 'velvet意思', 'red velvet', 'velvet是什么牌子口红', 'velvety怎么读', 'velva', 'velvet underground', 'velvet怎么读音']
bookworm	['bookworm', 'bookworm是什么意思啊', 'bookworm怎么读', 'bookworm beijing', 'bookworm官网', 'bookworm oxford', 'bookworm是个贬义词吗', 'bookworm书虫系列']
instyle2	['instyle', 'instyle造型', 'instyle中文是什么意思', 'instyle造型价目表', 'instyle是什么牌子', 'instyle是什么意思', 'instyle创始人', 'instyle造型官网', 'instyle优家画报', 'instyle美发创始人']
WAGAS	['wage', 'wagon', 'wagas', 'wages', '瓦格纳', '哇嘎', 'wait', 'wago', 'wagyun', 'wagner']
HUAZHU_Hanting	['华住汉庭酒店wifi密码', '华住汉庭', '华住汉庭酒店', '华住汉庭官网', '华住汉庭宁波', '华住汉庭酒店数据泄漏', '华住汉庭wifi密码认证', '华住汉庭wifi密码', '华住汉庭索菲亚', '华住汉庭的密码是什么']
HaiDiLaoDianCai	['海底捞点菜攻略', '海底捞点餐攻略', '海底捞点菜攻略2人', '海底捞店长日记', '海底捞点餐', '海底捞点菜', '海底捞点菜的平板咋用', '海底捞点餐系统', '海底捞点餐技巧', '海底捞点菜都是ipad']
请晋山西餐社	['请晋山西餐社怎么样', '请晋山西餐社乔家大院', '请晋山西餐社(好运街店)怎么样', '请晋山西餐社(三里屯时光列车)怎么样', '请晋山西餐社(好运街店)', '请晋山西餐社老板', '请晋山西餐社三里屯', '请晋山西餐社加盟']
眉州东坡酒楼	['眉州东坡酒楼', '眉州东坡菜单', '眉州东坡酒楼电话', '眉州东坡集团', '眉州东坡网上订餐', '眉州东坡酒楼菜单', '眉州东坡电话', '眉州东坡官网', '眉州东坡小吃', '眉州东坡门头沟']
Algorithm	['algorithm', 'algorithmic', 'algorithm是什么意思', 'algorithm函数', 'algorithm翻译', 'algorithm头文件', 'algorithm negotiation fail', 'algorithmic trading', 'algorithm怎么读', 'algorithmic什么意思']
haolinju	['浩林', '号令天下', '好邻居', '号令天下手机号码测吉凶', '号令', '号令天下手机号码测吉', '郝林', '海陵岛', '好领导', '豪麟']
F-SPACE	['防食品安全教育记录', '枫树皮熬水可以喝吗', '佛山平安车险营业厅', '分手pia戏文本', '佛山平安银行地址查询', '法师平a最大输出', '抚松平安保险公司地址', '丰顺平安新闻', '佛山平安保险网点查询', '发烧泡艾草浴有效果吗']
buerjiuguan2	['不二酒馆怎么样', '不二酒馆斯斯与帆']
wangjingxiaoyao	['望京小腰', '望京小腰是什么腰子', '望京小腰图片', '望京小腰加盟多少钱', '望京小腰总店', '望京小腰加盟', '望京小腰哪家是真的', '望京小腰做法', '望京小腰总店在哪', '望京小腰怎么样']
cafeflo	['caffeine', 'caffe框架', 'caffeine什么意思', 'cafe法语', 'cafe翻译', 'caffe和coffee区别', 'caffe是什么意思啊', 'caffeinism', 'caffeine anhydrous', 'caffeine是什么药']
WALA1	['walk', 'wall', 'wallet', 'walrus', 'walking', 'walnut', 'walked', '哇 李宇春', 'walkman', 'walt']
Mojitoman	['mojito墨西哥餐厅', 'mojito焖烧杯怎么样', 'mojito莫吉托']
yinyuetai.com	['音乐太长怎么剪短', '音乐太长怎么剪辑手机', '音悦台创始人', '音悦台车机版', '音乐太长怎么剪切', '音悦台车机破解版', '音乐太长怎么修剪音乐', '音悦台创始人时颖', '音乐台超视距雷达', '音悦台采访张艺兴']
xiaojungan	['小郡肝', '小军鼓', '萧敬腾', '小郡肝是什么', '小郡肝串串香', '肖俊光', '小郡肝串串', '小郡肝 jiameng.com', '小郡肝加盟费', '小郡肝串串香加盟骗局']
Revolution5G	['revolutionary', 'revolution吉他谱', 'revolution是什么意思', 'revolution吉他', 'revolution教学', 'revolution指弹', 'revolution歌词', 'revolution歌曲', 'revolution ct', 'revolution下载']
thebell	['thebes', 'thebest', 'thebez手表是什么牌子', 'thebest是什么牌子', 'thebez', 'thebeat什么意思', 'theben定时器如何设置', 'the best is for you什么意思', 'thebee', 'thebest什么意思']
Revolution	['revolution', 'revolutionary', 'revolution吉他谱', 'revolute', 'revolution是什么意思', 'revolution吉他网易云', 'revolution吉他音频', 'revolution one', 'revolution指弹mp3', 'revolution法国品牌']
yigonglihaixianfang	['一公里海鲜坊商户概况', '一公里海鲜坊用户评论', '一公里海鲜坊网友评论']
珍滋味港式粥火锅	['珍滋味港式粥火锅菜单', '珍滋味港式粥火锅(工体店)', '珍滋味港式粥火锅加盟', '珍滋味港式粥火锅(新源西里店)怎么样', '珍滋味港式粥火锅官网', '珍滋味港式粥火锅怎么样', '珍滋味港式粥火锅(工体店)商户概况', '珍滋味港式粥火锅价格', '珍滋味港式粥火锅(工体店)网友评论', '珍滋味港式粥火锅 新源里店']
WeWork	['wework', 'wework上海', 'wework北京', 'wework是什么公司', 'wework官网', 'wework深圳', 'wework融资亿', 'rework', 'wework招聘', 'wework成都']
THERUG	['there', 'therefore', 'therapy', 'thermo', 'there be句型', 'thermos', 'thermal', 'thereby', 'there怎么读', 'there is']
WALA2	['walk', 'wall', 'wallet', 'walrus', 'walking', 'walnut', 'walked', '哇 李宇春', 'walkman', 'walt']
STAFOOD	['stafood', 'stafood面馆无双怎么样', 'stafood面馆无双官网', 'stafo润滑油', 'stafood面馆无双菜单']
ONSTAR	['onstage', 'onstar', 'const', 'onste', 'onstage的意思', 'instead', 'onstar系统', 'instrument', 'onste是什么意思', 'onstart']
C5cafe	['c5彩票下载安装', 'c5残疾人可以考驾照吗', 'c5参数', 'c5残疾人能开哪几种车', 'c5残疾人自动挡汽车', 'c5残疾人专用车图片', 'c5槽钢', 'c5彩屏智能手环', 'c5残疾车是什么车']
IBIZA	['ibiza', 'ibis', 'ibil', 'ibiza绝地求生', 'ibid', 'ibiza耳机', 'ibike', 'ibiden', 'ibiza设置', 'ibiza微博']
rich-healthcare	['rich-healthcare.', 'rich-healthcarecm', "rich-healthcarecom~911100560120一395E'"]
didiao2	['低调组合', '低调看', '低调看直播', '低调图片', '地点', '低调组合承认是情侣', '地垫', '低调高手', '地点副词', '低调奢华']
