tingyun	['听雨', '庭院', '庭院设计', '停运', '庭有乔木茂如星免费全书阅读', '听音乐', '停运高铁', '庭院深深', '停运列车', '停运车次查询']
meishenxuqing5G	['美神煦氰', '美神煦氰医疗美容', '美神煦氰美啦门诊', '美神煦氰整形', '美神煦氰美啦门诊地址', '美神煦氰美啦门诊骗', '美神煦氰生物胶粘合', '美神煦氰結婚了嗎', '美神煦氰双眼皮价格']
CUPONE	['cupola', 'cupon', 'cupor', 'cupone', '醋泼酸尼松片是什么药', '醋泼羊头', '醋泼松尼片作用', 'cupor什么牌子', 'cupolo摩托']
yuxueyuan	['育学园', '寓学于乐', '寓学于乐的意思是什么', '育学园app下载', '育学园会员值得吗', '育学园诊所', '育学园电话', '寓学于乐下一句是什么', '寓学于趣', '寓学于趣是什么意思']
huashangjiudian	['华商酒店', '华商酒店管理有限公司', '华商酒店 三元桥', '华商酒店(厦门湾店)怎么样', '华商酒店-中餐厅怎么样', '华商酒店电话漳州', '华商酒店(淦河大道)怎么样', '华商酒店-KTV怎么样', '华商酒店是国企吗']
CUPONE-2	['cupone什么意思']
西贝莜面村	['西贝莜面村', '西贝莜面村12个必点菜', '西贝莜面村怎么念', '西贝莜面村让加盟吗', '西贝莜面加盟费', '西贝莜面事件', '西贝莜面村创始人', '西贝莜面村菜品图片', '西贝莜面村400电话号码', '西贝莜面里什么菜好吃']
bjfyxybg	['包茎费用需要多少钱', '不见风雨下一句是什么', '北京翻译学院是几本', '北京翻译学院的分数线', '北京翻译学院怎么样', '不惧风雨下一句是什么']
beifangyouyicun	['北方又一村电话', '北方又一村怎么样', '北方又一村营业时间', '北方又一村商户概况', '北方有一菜名叫哈什么着', '北方又一村法人是谁', '北方又一村在线菜单']
suzumei	['suzumu', 'suzume', 'suzumu事件', 'suzume翻译', 'suzumei北京', 'suzume 什么品种', 'suzumba', 'suzuma', 'suzumu复出', '素卒面膜怎么样']
@张亮麻辣烫	['张亮麻辣烫', '张亮麻辣烫是谁开的', '张亮麻辣烫加盟费用', '张亮麻辣烫加盟', '张亮麻辣烫加盟费用需要多少钱', '张亮麻辣烫创始人和杨国福', '张亮麻辣烫老板叫什么', '张亮麻辣烫官网', '张亮麻辣烫和杨国福哪个好吃', '张亮麻辣烫多少钱一斤']
CUPONE-1	['cupone什么意思']
WAGAS	['wage', 'wagon', 'wagas', 'wages', '瓦格纳', '哇嘎', 'wait', 'wago', 'wagyun', 'wagner']
dizhibinguan	['地质宾馆', '地质宾馆电话', '地址宾馆坐几路公交车']
HomeInns	['homeinn', 'homeinn什么意思', 'homeins']
helijia-bj	['河狸家', '河狸家官网', '河狸家美甲师真实收入', '河狸家怎么样', '河狸家客服电话', '赫里将军', '河狸家新手能接到单吗', '河狸家的现状', '合理减肥法', '河狸家app下载']
DAVOST	['大脖子病']
HaiDiLaoDianCai	['海底捞点菜攻略', '海底捞点餐攻略', '海底捞点菜攻略2人', '海底捞店长日记', '海底捞点餐', '海底捞点菜', '海底捞点菜的平板咋用', '海底捞点餐系统', '海底捞点餐技巧', '海底捞点菜都是ipad']
Bankcomm	['bankcomm.com', 'bank code什么意思']
小筑酒店2	['小筑酒店']
黎明园宾馆	['遵化黎明园', '杭州黎明园', '北京黎明园']
wanglibank	['网利宝', '网利宝最新消息', '网利宝交流群', '网利宝最新消息2019', '网利宝的钱还能拿回来吗', '网利宝立案', '王力保险柜', '网利宝最新消息2019年6月', '网利宝app下载', '网利宝新闻']
meishenxuqing	['美神煦氰医疗美容', '美神煦氰', '美神煦氰美啦门诊', '美神煦氰整形']
xibeihanzi	['西北航空', '西北汉子', '西北汉子的性格特点', '西北航空大学', '西北航天航空大学', '西北航空公司', '西北汉子餐厅', '西北行攻略', '西北航空公司官网', '西北航空85号']
helijia	['鹤立鸡群', '河狸家', '鹤立鸡群的意思', '格力', '鹤立鸡群是什么生肖', '和离记', '河狸家官网', '河狸家怎么样', '何丽娟', '赫里将军']
huajiayiyuan	['花家怡园', '花家怡园四合院', '花家怡园菜单', '花家怡园东直门店', '花家怡园圆明园店', '花家怡园惠新店', '花家怡园融科店', '花家怡园金融街店', '花家怡园清华西路店', '花家怡园四季青店']
Bluche	['bluck', 'bluce', 'blucher', 'bluch', 'bluce什么意思', 'bluck是什么意思颜色', 'bluck车', 'blued', 'blucon', 'blush']
Homeinns	['homeinn', 'homeinn什么意思', 'homeins']
wennuandelvtu	['温暖的旅程作文600字', '温暖的旅程', '温暖的旅程作文500字', '温暖的旅程800字', '温暖的旅程作文800字', '温暖的旅行600字作文', '温暖的旅程700字', '温暖的旅程作文450字', '温暖的旅程600字', '温暖的旅程作文开头']
24小时自助图书馆	['24小时自助图书馆书籍多吗', '24小时自助图书馆', '24小时自助图书馆怎么使用', '24小时自助图书机', '24小时自助图书馆加盟', '24小时自助图书馆费用', '24小时自助图书馆退卡', '24小时自助图书馆(大东门街分馆)怎么样', '24小时自助图书馆 评论']
lanhuhui	['澜湖会', '蓝湖汇vip公馆', '蓝湖环保科技有限公司', '蓝湖汇vip公馆 2000多', '澜湖会世纪温泉会所', '蓝狐好养吗', '蓝狐和雪狐哪个好养', '懒呼呼', '懒胡汉三全集', '懒乎乎']
HaiDiLaoHuoGuo	['海底捞火锅', '海底捞火锅加盟', '海底捞火锅价格表', '海底捞火锅底料', '海底捞火锅加盟费多少', '海底捞火锅怎么吃', '海底捞火锅成立于哪一年', '海底捞火锅底料怎么调', '海底捞火锅底料哪个好吃', '海底捞火锅加盟费吗']
wanglaoliu	['王老六', '王老六铁锅炖鱼', '王老六说唱歌词', '王老六怎么不更新了', '王老六的说唱bgm', '王老六大街上手搂嫩模', '王老驴,桂花', '王老六铁锅炖鱼创始人', '王老丽创作的原声', '王老六淘宝店叫什么']
Starbucks	['starbucks', '星巴克', '抖音那个starbuc']
shikongtang	['时空塔', '时空泰运回馈', '十孔陶埙指法', '十孔陶笛指法', '十孔陶埙怎么吹响', '时空逃杀 小说', '十孔陶笛指法视频', '时空太阳8宫', '时空探员天赋']
salahuaer	['撒拉花儿西域美食', '撒拉花儿', '撒拉花儿是什么意思', '撒拉花儿太阳宫电话', '萨拉花儿太阳宫', '撒拉花儿亚运村店电话', '萨拉花饭店', '撒拉花是什么意思', '撒拉话是什么话', '撒拉话']
siyeniula	['四爷牛拉', '四爷牛拉总店在哪', '四爷牛拉面门店', '四爷牛拉是清真的吗', '四爷钮祜禄小说', '四爷牛拉创始人', '四爷牛拉创始人吴熙花']
beiwaiqingshao	['北外青少', '北外青少英语', '北外青少英语校区', '北外青少英语校区电话', '北外青少校区', '北外青少官网', '北外青少英语培训中心怎么样', '北外青少英语app安卓', '北外青少英语官网平台', '北外青少英语费用']
MeiNianDaJianKang	['美年大健康', '美年大健康体检中心', '美年大健康体检中心官网查看报告', '美年大健康体检可信吗', '美年大健康体检中心报告查询app', '美年大健康体检中心电话', '美年大健康体检中心怎么样', '美年大健康官网', '美年大健康股票', '美年大健康招聘']
muwushaokao	['木屋烧烤', '木屋烧烤菜单', '木屋烧烤创始人', '木屋烧烤加盟费多少', '木屋烧烤官网', '木屋烧烤营业时间', '木屋烧烤老板', '木屋烧烤店', '木屋烧烤几点海鲜半价']
4008190099	['4008190099']
menggongfang	['梦工坊', '梦工坊咖啡吧', '梦工坊影城', '梦工坊app', '梦工坊咖啡', '梦工坊影城蔡塘', '梦工坊影城在厦门哪里', '梦工坊咖啡营业时间', '梦工坊优惠券怎么用']
saboten	['sabotage', 'saboteur', 'saboten', 'sabotage是什么意思', 'saboteur桌游规则', '萨博图片', '萨博头像', '萨博图片高清海贼王', '萨博坦达', '萨博听到艾斯死讯是哪一集']
PizzaHut	['pizza火币', 'pizza盒子能进微波炉', 'pizza汉语意思是什么', 'pizza烘烤温度时间', 'pizza盒子设计这样用', 'pizza好消化吗', 'pizza汉语', 'pizza烘焙', 'pizza黄游', 'pizza黄游戏']
