LunYuCunZhuang.	['lunyucunzhuang', 'lunyucunzhuangzhijinjiyouxi', 'lunyucunzhuang(tian鹅wandian)zenmeyang']
AppleStore	['applestore', 'applestorewufalianjiezenmeban', 'applestoreyanzhengmalaoshibaide', 'applestorewufadenglu', 'apple storewufaxiazai', 'apple storezenmegaichengzhongwen', 'apple storezidongkoufei', 'apple storewufalianjie', 'applestoreshishenmeyisi', 'applestoredabukai']
vika1	['viking', 'viki', 'vikasu', 'vikki', 'vika', 'vikey', 'vike', 'viky', 'vicky', 'village']
UYOUNG	['uyou', 'uyouka', 'uyou爱shide', 'uyoukefu', 'uyouyingyeting', 'uyouju', 'uyoujizhongfayin', 'uyouyuan', 'uyouduapp', 'uyoukefudianhuashiduoshao']
ChateauStarRiver	['chateaustarriver.com']
QianZiLian-2	['qianzilian', 'qianzilianzudao', 'qianzilianzudaoyoufeijima', 'qianzilian', 'qianziliang', 'qianziliang', 'qianzilianbiqianmingsheji', 'qianzilianbiqianming', 'qianzilianzuliaohuisuozenmeyang', 'qianzilianzhujiangdijingdianzuliao']
homeinns3	['homeinnshenmeyisi']
Bankcomm	['bankcomm.com', 'bank codeshenmeyisi']
homeinns2	['homeinnshenmeyisi']
TangGong	['tanggongshinvtu', 'tanggou', 'tanggongyuanzhu', 'tanggonghongqiqiaoliuxueshipin', 'tanggou', 'tanggonghaixianfang', 'tanggongmeirentianxia', 'tanggonghong', 'tanggong', 'tanggongyan']
chaoyangjianshen	['zhaoyangjianshejituanyouxiangongsi', 'zhaoyangjiansheyinhang', 'zhaoyangjianshencao', 'chaoyangjiansheyinhanggongzuoshijian', 'zhaoyangjianshenfangyuekajiagebiao', 'zhaoyangjianshenfang', 'zhaoyangjianshishijian', 'zhaoyangjiansheyinhangwangdian', 'zhaoyangjianshencaodishi二tao', 'chaoyangjianshenfang']
眉州东坡酒楼	['meizhoudongpowangshangdingcan', 'meizhoudongpoxiaochi', 'meizhoudongpoguanwang', 'meizhoudongpojiuloudianhua', 'meizhoudongpojituan', 'meizhoudongpocaidan', 'meizhoudongpomentougou', 'meizhoudongpojiulou', 'meizhoudongpodianhua', 'meizhoudongpojiuloucaidan']
聚点串吧-甘露园店	['judianchuanbaganluyuandian']
jazz.ya	['jazzshishenmewuzhong', 'jazzshishenmeyisizhongwenfanyi', 'jazz funkshishenmewuzhong', 'jazzwu', 'jazzcatwudaokaojishipin', 'jazz hippo', 'jazzzenmedude', 'jazzshishenmeyisizhongwen', 'jazzbentian', 'jazzfenlei']
AMBER	['amber', 'ambition', 'ambulance', 'ambush', 'ambiguous', 'ambitious', 'ambassador', 'ambient', 'ambiguity', 'amc']
眉州东坡-12	['meizhoudongpojiulou', 'meizhoudongpojiuloudianhua', 'meizhoudongpojiuloucaidan', 'meizhoudongpojiuloushunyidian', 'meizhoudongpobidiancai', 'meizhoudongpoyizhuangdiandianhua', 'meizhoudongpocaoqiaodiandianhua', 'meizhoudongpowanggang', 'meizhoudongpojiulouyizhuangdian', 'meizhoudongpojiulouguanwang']
rujia	['rujiao', 'rujia', 'rujiaoqi', 'rujiao', 'rujia', 'rujiaozhen', 'rujiaochuangdian', 'rujiajiudian', 'rule', 'rujiaoyi']
太平洋咖啡	['taipingyangbaoxian', 'taipingyangqichewang', 'taipingyangzhanzheng', 'taipingyangchexian', 'taipingyangqiche', 'taipingyangbaoxiandianhua', 'taipingyangbaoxiangongsi', 'taipingyangdiannaowang', 'taipingyangbaoxianzenmeyang', 'taipingyangjianshe']
YFJAZZ	['yuefenjiao案', 'yangfangjian安chengbenyibanduoshao', 'yufajiao案', 'yifujia氨lundezuoyong', 'youfuji按yateng', 'yuefenjiao案daoru', 'yunfujiao爱chuhanchouzenmeban', 'youfuji按tongchixuhaojiu', 'yunfujiu爱chixiguazenmeban', 'yunfuji安quanbiaozhunbiaozhi']
CMCC-WEB	['cmccwebdenglujiemian', 'cmccwangluozenmelianjie', 'cmccwebzenmelianjie', 'cmccwebmianfeizhanghaomima', 'cmccwangluo', 'cmccwebshishenmewangluo', 'cmccweb', 'cmccwebshoufeima', 'cmccwebzenmemianfeilianjie', 'cmccwuxianwang']
100inn	['100iu', '100mi', '100iudengyuduoshaohaoke', '100iu/ml', '100iushishenmeyisi', '100inch', '100iudengyuduoshaoml', '100iu ug', '100iudengyuduoshaomg']
qianzilianzudao	['qianzilianzudao', 'qianzilianzudaoyoufeijima', 'qianzilianzudaoxiaofeijiage', 'qianzilianzudaozenmeyang', 'qianzilianzudao', 'qianzilianzudao(jinniujiehetangyuesedian)zenmeyang', 'qianzilianzudao(yizhuangfendian)zenmeyang', 'qianzilianzudaoyouxiaojiema', 'qianzilianzudao(muxiyuandian)zenmeyang', 'qianzilianzudao(xikuangjiedian)zenmeyang']
HUAZHU-Hanting	['huazhuhantingdemimashishenme', 'huazhuhanting', 'huazhuhantingningbo', 'huazhuhantingjiudianwifimima', 'huazhuhantingsuofeiya', 'huazhuhantingjiudianshujuxielou', 'huazhuhantingwifimima', 'huazhuhantingwifimimarenzheng', 'huazhuhantingjiudian', 'huazhuhantingguanwang']
7daysInn	['7daysin']
misshuo	['missha', 'missing', 'misshapen', 'misshashishenmepaizi', 'mission', 'missile', 'missing you', 'misshems', 'misshoxiaoxiaosasa', 'misshishenmeyisi']
tianehui	['tian鹅hu', 'tian鹅hubaleiwu', 'tian鹅huhuayuan', 'tian鹅huwanda', 'tian鹅hudajiudian', 'tian鹅hugushi', 'tian鹅huzuozhe', 'tian鹅huzainali', 'tian鹅hujingqu', 'tian鹅hucaoyuan']
HI辣火锅	['hilahuoguo', 'hilahuoguochuangshiren', 'hilaxiaolongxia', 'hilahuoguodengjiajiaguanwang', 'hilahuoguozaineixiechengshi', 'hilahuoguojiamengfei', 'hilahuoguojiamubiao', 'hilaxiaolongxiazenmeyang', 'hilahuoguobeijingnaliyou', 'hilahuoguobeijingdizhi']
24小时自助图书馆	['24xiaoshizizhutushuguan(dadongmenjiefenguan)zenmeyang', '24xiaoshizizhutushuguantuika', '24xiaoshizizhutushuji', '24xiaoshizizhutushuguanshujiduoma', '24xiaoshizizhutushuguanjiameng', '24xiaoshizizhutushuguan pinglun', '24xiaoshizizhutushuguan', '24xiaoshizizhutushuguanfeiyong', '24xiaoshizizhutushuguanzenmeshiyong']
JuZiShu_QNL	['jiezishuqilin', 'jiezishuqilinxilie', 'jiezishuqilinbaiduyun', 'juzishuqilin', 'jiezishuqilinzaixianguankan', 'jiezishuqilinxilieshijianxian', 'jiezishuqingnianluxiaoqudianhua', 'jiezishuqueweiliangyuansutupian', 'jiezishuqianchajishushipin', 'jiezishuqianye蛾yongshenmeyao']
chongqingxiaomian	['chongqingxiaomian', 'chongqingxiaomiandezuofa', 'chongqingxiaomianjiamengdian', 'chongqingxiaomiandezuofajipeiliao', 'chongqingxiaomiantupian', 'chongqingxiaomianpeixunnajiazuihao', 'chongqingxiaomianjiamengfeiduoshaoqian', 'chongqingxiaomianjiamengyaoduoshaoqian', 'chongqingxiaomixiong儿tongyiyuankoubei']
jinshoushao	['jinshoushao', 'jinshoushan', 'jinshoushi', 'jinshoushijiage', 'jinshoushihuishou', 'jinshoushizenmeqingxicailiang', 'jinshoushaodongbeicai', 'jinshoushineigepaizihao', 'jinshoushenmezi', 'jinshoushushiliucheng']
shishangmatou	['shishangmatouquanguoliansuodian', 'shishangmatou', 'shishangmatoumeirongmeifa', 'shishangmatoubeijingliansuodian', 'shishangmatouyaojinhudongshizhang', 'shishangmatoudongbadian', 'shishangmatouguquanhetong', 'shishangmatoushangxueyuanguquan', 'shishangmatouqingnianludian', 'shishangmatousongjiazhuangdian']
LunYuCunZhuang2	['lunyucunzhuang', 'lunyucunzhuangzhijinjiyouxi', 'lunyucunzhuang(tian鹅wandian)zenmeyang']
ziroom	['ziroom', 'zirong', 'ziroomziru', 'ziru', 'ziroommorenwifimima', 'zero', 'zirong', 'zircon', 'ziroyundongkongzhixitong', 'ziruo']
MeowCafe	['meowcat']
QianZiLian-1	['qianzilian', 'qianzilianzudao', 'qianzilianzudaoyoufeijima', 'qianzilian', 'qianziliang', 'qianziliang', 'qianzilianbiqianmingsheji', 'qianzilianbiqianming', 'qianzilianzuliaohuisuozenmeyang', 'qianzilianzhujiangdijingdianzuliao']
PizzaHut	['pizzahezinengjinweibolu', 'pizzahuangyou', 'pizzahanyu', 'pizzahongbei', 'pizzahezishejizheyangyong', 'pizzahaoxiaohuama', 'pizzahuangyouxi', 'pizzahongkaowendushijian', 'pizzahanyuyisishishenme', 'pizzahuobi']
LunYuCunZhuang3	['lunyucunzhuang', 'lunyucunzhuangzhijinjiyouxi', 'lunyucunzhuang(tian鹅wandian)zenmeyang']
@全羊肉泡馍	['quanyangrouguancaipudaquan', 'quanyangroutangdezuofadaquan', 'quanyangroubaozhuangzhixiangtupian', 'quanyangroudejiegoutu', 'quanyangroutangdezuofajipeiliao', 'quanyangroushichangjiage', 'quanyangrouzenmezuohaochi', 'quanyangroudetupian', 'kaoquanyangrou', 'yangroudezuofadaquanyangrou']
.@博成雅居酒楼	['bochengyajujiulou', 'bochengyajuqingnianlu', 'beijingbochengyaju']
PUPPY_TOWN	['puppytouyingyiguanwang']
huaniucanguan	['huaniucanguan']
WX-QJD	['wuxinqianlongquanwenmianfeiyuedu', 'weixinqunfasuoyourenzenmefa', 'wuxianqiyunzhuzai', 'weixinqun', 'weixinqinglvtouxiang', 'weixinqianmingyijuhuazhiziji', 'weixinqianming', 'weixinqunshoukuanzenmenong', 'weixinqunming', 'weixinqunfa']
runjiangnan2	['runjiangnanzhaoyangdayuechengdian', 'runjiangnan', 'runjiangnanlvxingshe', 'runjiangnanlvxingshezenmeyang', 'runjiangnan dingcan dianhua', 'runjiangnanreshuiqi', 'runjiangnandaobi', 'runjiangnanreshuiqi安zhuang', 'runjiangnancantingzenmeyang']
LianJia	['lianjini', 'lianjunjie', 'lianjiyouxi', 'lianjia', 'lianjiawang', 'lianjie', 'lianjiangqiantianfashengyiqichehuo', 'lianjia', 'lianjingya', 'lianjin']
HEYTEA	['heyteaxicha guanwang', 'heyteazenmedu', 'hao儿yutupian', 'heyteashishenmeyisi', 'heyteaxichajiamengfeidagaiduoshao', 'hai尔yituosanzhongyangkongtiao', 'heytea', 'hai尔yituoyifengguanjibaoe5', 'heyteaxicha', 'heyteaxichajiamengma']
Starbucks	['douyinnagestarbuc', 'xingbake', 'starbucks']
bianlifeng	['bianlifeng', 'bianlifengjiamengfeiduoshao', 'bianlifengguanwang', 'bianlifengzhaopin', 'bianlifengyouhuiquan', 'bianlifenggongzizenmenamegao', 'bianlifengliansuobianlidian', 'bianlifengjiamengfei', 'bianlifengjiameng', 'bianlifengapp']
weishiguang	['weishiguanfanliu', 'weishiguanfanliubingdezhengzhuang', 'weishiguanfanliuchishenmeyao', 'weishiguangyunibukegufu', 'weishiguanfanliuzenmeye', 'weishiguanfanliubingzenmezhi', 'weishiguanfanliubingnengzhihaoma', 'weishiguanfanliubingdezhengzhuangchishenmeyao', 'weishiguanfanliudezhiliao', 'weishiguanfanliubingnenghuoduojiu']
Waipojia	['waipojia', 'waipojiacaidan', 'waipojiajiamengfeiduoshao', 'waipojiabidianzhaopaicai', 'waipojialaoban', 'waipojiaguanwang', 'waipoju', 'waipojiadizhi', 'waipojiazhaopaicai', 'waipojiawaimai']
西贝莜面村	['xibeiyoumianlishenmecaihaochi', 'xibeiyoumiancuncaipintupian', 'xibeiyoumiancun400dianhuahaoma', 'xibeiyoumiancunrangjiamengma', 'xibeiyoumiancunchuangshiren', 'xibeiyoumianshijian', 'xibeiyoumiancunzenmenian', 'xibeiyoumiancun12gebidiancai', 'xibeiyoumiancun', 'xibeiyoumianjiamengfei']
WAGAS	['wagena', 'wagyun', 'wagas', 'waga', 'wagner', 'wago', 'wages', 'wagon', 'wait', 'wage']
amber	['amber', 'ambition', 'ambulance', 'ambush', 'ambiguous', 'ambitious', 'ambassador', 'ambient', 'ambiguity', 'amc']
BJLYFCYY	['beijingliyingfuchanyiyuanjiage', 'beijingliyingfuchanyiyuanrenliu', 'beijingluyingfangchezhan', 'bijieliyafangchan', 'beijingliyingfuchanyiyuanzhaopin', 'baojialiyafangchantouzi', 'beijingliuyuefenchuanyifutupian', 'beijingliyingfuchanyiyuanxiaofei', 'beijingliyingfuchanyiyuan', 'beijinglvyoufeicuigouwudian']
runjiangnan	['runjiangnanzhaoyangdayuechengdian', 'runjiangnan', 'runjiangnanlvxingshe', 'runjiangnanlvxingshezenmeyang', 'runjiangnan dingcan dianhua', 'runjiangnandaobi', 'runjiangnanreshuiqi', 'runjiangnanreshuiqizenme安zhuang', 'runjiangnancantingzenmeyang']
DiaoYeniunan	['diaoyeniunan', 'diaoyeniunanshibaideyuanyin', 'diaoyeniunanchuangshiren', 'diaoyeniunanxianzhuang', 'diaoyeniunancaidanjiamubiao', 'diaoyeniunanxianzhuang2019', 'diaoyeniunanxi安dian', 'diaoyeniunankuaizi', 'diaoyeniunanlaoban', 'diaoyeniunanwaimaitupian']
xianaohui	['xian傲haokanma', 'xianaohongsezenmexidiao', 'xi安奥hua', 'xi安奥hengkejiyouxiangongsi', 'xian傲hedadaoduxingdelianxi', 'xi安凹henxiufu', 'xi安奥huizhiyezhangxiaopu', 'xi安奥huizhichang', 'xian傲hedadaoduxing', 'xi安奥hanguoji']
BEERALL	['beeray', 'beerall']
homeinns	['homeinn', 'homeinnshenmeyisi', 'homeins']
XuePankaochuan	['xuepankaochuan', 'xuepankaochuan zhangyixing', 'xuepankaochuanweishenmejiaoxuepan', 'xuepankaochuanlaobanshishui', 'xuepankaochuanguanwang', 'xuepankaochuan(zhaoyangdayuechengdian)', 'xuepankaochuan(lansegangwandian)', 'xuepankaochuan(zhaoyangdayuechengdian)wangyoupinglun', 'xuepankaochuan dayuecheng', 'xuepankaochuanshishuikaide']
yingpaisijianshen	['yingpaisijianshen', 'yingpaisijianshenniankajiagebiao', 'yingpaisijianshenqicai', 'yingpaisijianshenjulebu', 'yingpaisijianshenjiage', 'yingpaisijianshendianhua', 'yingpaisijianshenzenmeyang', 'yingpaisijianshenqicaijiage', 'yingpaisijianshenguanwang', 'yingpaisijianshenquanguoduoshaojia']
xiaojungan	['xiaojunganshishenme', 'xiaojungan jiameng.com', 'xiaojungan', 'xiaojunganchuanchuanxiang', 'xiaojunganchuanchuan', 'xiaojunganchuanchuanxiangjiamengpianju', 'xiaojungu', 'xiaojunganjiamengfei', 'xiaojunguang', 'xiaojingteng']
N27th	['n270', 'n270cpu', 'n27huochemoxing', 'n270 ruanluyou', 'n27lu', 'n270qunhui', 'n270gonghao', 'n27204', 'n270 j1800', 'nv27suidiaotoufazenmehuishi']
32bar	['32bit', '32buguangchangwu', '32bitshishenmeyisi', '32cun', '32bpsguankan', '32bfeiji', '32bit data transfer', '32bubengdiyao']
pinkbaby	['pinkbao', 'pinkbagzenmeduyin', 'pinkbaoshenmepaizi', 'pinkbaoshenmedangci', 'pinkbalidaofenkele', 'pinkbaobaoguanwang', 'pinkbao', 'pinkbaidubaike']
shunshun	['shunshi而wei', 'shunshizhen', 'shunshisudu', 'shunshuituizhou', 'shunshouqianyang', 'shunshizhenshishenmefangxiang', 'shunshi', 'shunshiliaofa', 'shunshunliuxue', 'shunshun']
xiachixiashuan	['xiachixiashuan', 'xiachixiashuandezuofa', 'xiachixiashuanjiamengduoshaoqian', 'xiachixiashuanjiameng', 'xiachixiashuanxiahuoguo', 'xiachixiashuantupian', 'xiachixiashuanzenmeyang', 'xiachixiashuancaidan', 'xiachixiashuandizhi', 'xiachixiashuanxiahuoguojiamengfeiduoshaoqian']
jazzya	['jazzshishenmewuzhong', 'jazzshishenmeyisizhongwenfanyi', 'jazzwu', 'jazz funkshishenmewuzhong', 'jazzcatwudaokaojishipin', 'jazz rap', 'jazzzenmedu', 'jazzfenlei']
CHAOGuest	['chaogu二jishichangshishenme', 'chaoguetfshishenmeyisi', 'chaogu二badinglv', 'chaogu二shiniandetihui']
3AM-5G	['3ammeifa', '3ammeifachuangshirenjieshao', '3ammeifajianjie', '3amshenmeyisi', '3ammeifajiage', '3amzhichaojieshao', '3amlifadian', '3amgequ', '3amdadongweibo', '3amshishenme']
elephant1	['elephant', 'elephant zenmedu', 'elephantshenmeyisisi', 'elephantshishenmeyisizhongwen', 'elephant儿ge', 'elephantshishenmeyisi', 'elephant bird', 'elephant man', 'elephant in the room', 'elephantyinbiao']
shunshun2	['shunshuituizhou', 'shunshunlili', 'shunshunliuxue', 'shunshuirenqing', 'shunshun', 'shunshuiyuguan', 'shunsui', 'shunshuisuduhenishuisududegongshi', 'shunshundianying', 'shunshu']
hanjimmy	['hanjimianmo', 'hanjimianmozenmeyang', 'hanjimianmo安quanma', 'hanjimianmo', 'hanjimianmoxiaozhusuannai', 'hanjiming', 'hanjimaichongshishenmeyisi', 'hanjimokuai', 'hanjimlgshenmeyisi', 'hanjimmahetig']
TOKYOJING	['tokyojianxie', 'tokyojihaokan']
Jasmine	['jasmine', 'jasmin', 'jasmineyingwenming', 'jasmine flower', 'jasminezenmedu', 'jasmineshenmeyisizhongwen', 'jasminehezhangyixing', 'jasmina', 'jasmineyingwenmingjinji', 'jasminejikedianyin']
MARTINI	['martin', 'martial', 'martini', 'martina', 'martine', 'martial arts', 'martinshenmeyisizhongwen', 'martins', 'martin luther king', 'matrix']
InterContinental	['intercontinental', 'intercontinentalzhoujijiudian', 'intercontinentalshanghai', 'intercontinental hotel', 'intercontinental hotelshanghai', 'intercontinentalzenmedu', 'intercontinentalchangsha', 'intercontinentalguangzhou', 'intercontinentalchengdu']
INSTYLE-2	['instylezaoxing', 'instylezaoxingjiamubiao', 'instylezhongwenshishenmeyisi', 'instyleshishenmepaizi', 'instylechuangshiren', 'instylezaoxingguanwang', 'instyleyoujiahuabao', 'instylezazhi', 'instylemeifachuangshiren', 'instyleshishenmeyisi']
云川台球三里屯店	['yunchuantaiqiusanlitundian']
walahuoguo	['walahuoguo', 'walahuoguotupian']
1001night	['1001nights', '1001nightstianyexixiao', '1001night']
HomeInns	['homeins', 'homeinnshenmeyisi', 'homeinn']
BRACKET	['bracket', 'bracketshishenmeyisizhongwenfanyi', 'bracken', 'brackish', 'bracketshenmeyisi', 'brackla', 'bracke', 'tracker', 'brake', 'bracket coffee']
Moonshine	['moonshine', 'moonshishenmeyisi', 'moonshishui', 'moonshineshishenmeyisi', 'moonshishenmeyisizhongwen', 'moonshishenmeyisizhongwenfanyi', 'moonshishenmepaizi', 'moonshine conjecture', 'moonshine valley', 'moonshineshishenmepaizi']
sanfulong	['sanfulongjing fuqing', 'sanfulogo', 'sanfulongjingzuixinfangjia', 'sanfulongtingduoshaoyipingfang', 'sanfulongjinglongtingfangjia', 'sanfulongjingchuzhonghuapian', 'sanfulongjingshaxianxiaochi', 'sanfulou', 'sanfulongquanzhishibuquan', 'sanfulongjinglongting二shoufang']
小七君私房菜	['xiaoqijunsifangcai']
caixin	['caixukun', 'caixin', 'caixukunweibo', 'caixukunshengri', 'caixukuntupian', 'caixia', 'caixi']
mizuki	['mizu', 'mizuno', 'mizui', 'mizuzhengui', 'mizuho', 'mizuo', 'mizuci', 'mizuci', 'mizu', 'mizhidunyouyu']
rongshangzaoxing_5G	['rongshangzaoxing', 'rongshangzaoxing(gongtibeiluyidian)zenmeyang', 'rongshangzaoxing(gongtibeiluyidian)', 'rongshangzaoxing(gongtibeiluyidian) pinglun', 'rongshangzaoxing(gongtibeilu二dian)zenmeyang']
YJXCGY	['yanjianxiachui', 'yanjuexiangcun', 'yanjiaoxiachuimianxiang', 'yanjianxiachuitupian', 'yujuxiachenzhouquanchang', 'yuejingxuechengheise', 'yejianxingchekaishenmedeng', 'yanjiaoxiachui', 'yijiexiaochuxian', 'yijingxiaochijiebannale']
HaiDiLaoHuoGuo	['haidilaohuoguodiliaoneigehaochi', 'haidilaohuoguozenmechi', 'haidilaohuoguodiliao', 'haidilaohuoguojiameng', 'haidilaohuoguojiamengfeima', 'haidilaohuoguojiamengfeiduoshao', 'haidilaohuoguodiliaozenmetiao', 'haidilaohuoguojiagebiao', 'haidilaohuoguochengliyunayinian', 'haidilaohuoguo']
Toybox	['toybox', 'toubao', 'toyboyshishenmepaizide', 'toybearshishenmeyisi', 'toybusshishenmeyisi', 'toybearzenmedu', 'toubaodinifensanpian', 'toybiz', 'toyboybaobaozhengpinduoshaoqian', 'toybike']
NiaoTun	['niaotongti', 'niaotong', 'niaotang', 'niaotong', 'niaotou', 'niaotongtiyangxing', 'niaotanggao', 'niaotangyangxing', 'niaotang4+', 'niaoteng']
shijiajingpin	['shijiajingpinjiudian', 'shijiajingpinzhiliangruhe', 'shijiajingpinjiudianzenmeyang', 'shijiajingpin fate rider', 'shijiajingpinweiherucipianyi']
hongyitang_1f	['hongyitangzhongyiyuan', 'hongyitang', 'hongyitangzhongyiyuanzenmeyang', 'hongyitangxiameng', 'hongyitangzhongyiyuandianhua', 'hongyitang耳bihouyanjiuyuanzenmeyang', 'hongyitang', 'hongyitang', 'hongyitang wenshide', 'hongyitangshuikeyijiamengma']
super8	['superm', 'supervision', 'superior', 'superman', 'super', 'supermarket', 'super junior', 'superhero', 'superb', 'superficial']
yanweidie	['yanweidie', 'yanweidingli', 'yanweiding', 'yanweidiegeci', 'yanweidong', 'yanweiduojiunengsan', 'yanweidietupian', 'yanweiduiyunfuyoushenmeweihai', 'yanweidingguigechicun', 'yanweidiedeyuyi']
中国联通-D-one	['zhongguoliantongdongshizhangshishui', 'zhongguoliantongdongfangcaifu', 'zhongguoliantongdongshizhangjibie', 'zhongguoliantongdouyoushenmetaocan', 'zhongguoliantongdongpuyingyeting', 'zhongguoliantongdouyinkataocan', 'zhongguoliantongdonghaibinfendian', 'zhongguoliantongdongshizhangnianxin', 'zhongguoliantongdongguanyingyeting', 'zhongguoliantongdouyouneixiehaoduan']
xiaohongpaoS	['xiaohongpao', 'xiaohongpaolongxiaguan', 'xiaohongpaohuoguo', 'xiaohongpaochaye', 'xiaohongpaohuajiao', 'xiaohongpayicenglouyaoyong12miao', 'xiaohongpaolongxia', 'xiaohongpaipiqiukantuxiehua', 'xiaohongpaohedahongpaodequbie', 'xiaohongpaohuoguowangfuzhonghuan']
hooters1	['hooters', 'hooterscanting', 'hootersmaotouyingcanting', 'hootersshishenmeyisi', 'shooter', 'hooterslujiazui', 'hooterscantingyingyezhuangkuang', 'hootershishenmeyisi啊', 'gun shooter', 'cfjilinyiqushooter']
shuilintianyue	['shuilintianyue', 'shuilintianyue歺paijiage', 'shuilintianyueshanghugaikuang', 'shuilintianyuejiuba dongdaqiao']
hongyitang_2f	['hongyitangzhongyiyuan', 'hongyitang', 'hongyitangzhongyiyuanzenmeyang', 'hongyitangxiameng', 'hongyitangzhongyiyuandianhua', 'hongyitang耳bihouyanjiuyuanzenmeyang', 'hongyitang', 'hongyitang', 'hongyitang wenshide', 'hongyitangshuikeyijiamengma']
SIR.TEEN	['sirteenjiuba', 'sir.teen', 'sirteensankemenpiao', 'sirtex', 'sirteenfanyizhongwen', 'sirte', 'sirteenjiubamenpiao', 'sirteenjiudan', 'sirtec', 'sirteensantaiduoshaoqian']
MCD-ChinaNet	['mcd-chinanet']
D-one	['dota2', 'douluodalu', 'douyin', 'dongfangcaifuwang', 'douluodalu4zhongjidouluo', 'dota', 'down', 'doctor', 'doll', "don't"]
lantern	['lante', 'lanternduyin', 'lantern festival', 'lantehuilv', 'lanterguanwang']
xiaogechuanchuan	['xiaogechuanchuanxiang(sanlitundian)zenmeyang', 'xiaogechuanchuanxiang(yinheSOHOdian)zenmeyang', 'xiaogechuanchuanxiang(huilongguandian)zenmeyang', 'xiaogechuanchuanxiang(jinyuandian)zenmeyang', 'xiaogechuanchuanxiang(yinheSOHOdian)']
carmen	['carmax', 'carmel', 'carmine', 'carman', 'carmex', 'carol', 'garmin', 'carmina', 'carmendeyisi']
dk1308	['dk13fadongjizhengshitujie', 'dk138shezhixinmima', 'dk1306fadongjizhengshitu', 'dk138menjingaimima', 'dk138bianchengmima', 'daikuan13wansannianyuehaiduoshao', 'daikuan130wan25nianzenme', 'daikuan130wanlixishiduoshao', 'dongkang13shenghefukangneigehao', 'dakai137duankou']
dipingxian	['dipingxian', 'dipingxian4', 'dipingxianmotuoche', 'dipingxian3', 'dipingxianlingzhishuguang', 'dipingxiangongsi', 'dipingxian4shoujibanxiazai', 'dipingxianyingwen', 'dipingxianlimingshifen', 'dipingxianwuqixiang']
拿铁酒吧1	['natiejiubalaobanbeijing', 'natiejiubayiwu', 'natiejiubawuqu']
Ginger	['ginger', 'gingerbread', 'gongshangyinhang', 'gingerzenmeduyin', 'gongqijun', 'gongwaiyun', 'ginger ale', 'gingershenmeyisi', 'ginga', 'gingerly']
elephant	['elephant', 'elephant zenmedu', 'elephantshenmeyisisi', 'elephant儿ge', 'elephantshishenmeyisi', 'elephant bird', 'elephantshishenmeyisizhongwen', 'elephant in the room', 'elephantyinbiao', 'elephant seal']
niaotun	['niaotongti', 'niaotong', 'niaotang', 'niaotong', 'niaotou', 'niaotongtiyangxing', 'niaotanggao', 'niaotangyangxing', 'niaotang4+', 'niaoteng']
rijin	['riju', 'riji', 'rijuwang', 'rijigeshi', 'riji200', 'riji100zidaquan', 'rijiushengqing', 'rijindoujin', 'riji500zi', 'rijiayibi']
toastbar	['toastbingyinfenxing']
didiao	['didixinguizegongshi', 'didi', 'didikefu', 'didiaozuhe', 'dididaijia', 'didiwei', 'didichuxing', 'didibeifa550wanyuan', 'dididache', 'didiaokan']
LaoTie	['laotie', 'laotou', 'laotian', 'laotaitai', 'laotoule', 'laotailongzhong', 'laotaitaigaranny', 'laotieshishenmeyisi', 'laotouyu', 'laotang']
shangbangdaisi	['shangbangdaisijingpinjiudian', 'shangbangdaisijiudianwangping', 'shangbangdaisi', 'shangbangdaisijiudian', 'shangbangdaisijiudianjituan', 'shangbangdaisijiudianguanlijituanzenmeyang', 'shangbangdaisijiudianzhaopin', 'shangbangdaisiwenquanjiudian', 'shangbangdaisijiudianbeijing', 'shangbangdaisijiudianguanliyouxiangongsi']
马路牙子地桌烤肉5G	['maluyazidizhuokaoroujiameng', 'wangjingmaluyazidizhuokaorou', 'maluyazidizhuokaorou(gongtidian)zenmeyang', 'maluyazidizhuokaorou(gongtidian) gaikuang', 'maluyazidizhuokaorou(gongtidian)shanghugaikuang', 'maluyazidizhuokaorou(gongtidian)yonghupinglun', 'maluyazidizhuokaoroumima']
Playhouse	['playhouse', 'playhousejiuba', 'playhouseshenmeyisi', 'playhousechengdu', 'playhousejiubachuangshiren', 'playhousezenmedu', 'playhoumianshenmeshihoujiathe', 'playhousechangsha', 'playhousechengdujiage']
中国联通-Lugas	['zhongguoliantongluguyingyeting', 'zhongguoliantonglugouqiaojianyebudianhua', 'zhongguoliantonglugufujinyingyeting', 'zhongguoliantonglugouqiaoyingyetingdianhua', 'zhongguoliantongluguyingyetingzuogongjiao', 'zhongguoliantonglugouqiaoyingyetingditienazhanxia', 'zhongguoliantonglugouqiaofenjuzenmeyang']
DLOUNGE	['dlounengzuchengshenmedanci']
世家精品酒店	['shijiajingpinjiudian', 'shijiajingpinjiudianzenmeyang', 'qianjiangshijiajingpin', 'shijiajingpinjiudian(kenlidian)zenmeyang', 'shijiajingpinjiudiandianhua', 'shijiajingpinjiudiantuanjiehu', 'shijiajingpinjiudianyuding', 'shijiajingpinjiudianzhaopin']
xiaochunrihe	['xiaochunri', 'xiaochunrihe', 'xiaochunrihelousimao', 'xiaochunrihe lounuomaoweipan', 'xiaochunrihelousimaobaiduyun', 'xiaochunrihelousimaoquanwenyuedu', 'xiaochunrihebylousimao', 'xiaochunrihelounuomaotxtbaiduyun', 'xiaochunrihebaiduyunpan']
haidilaoPOS	['haidilaopaihao', 'haidilaopijiu', 'haidilaopaiduiquhaoweixin', 'haidilaopeiliaozenmetiao', 'haidilaopaihaoguolezenmeban', 'haidilaopingjunmeirenduoshaoqian', 'haidilaopaidui', 'haidilaopaihaozenmepai', 'haidilaopijiuduoshaoqianyiping', 'haidilaopaiqian']
velvet	['velvet', 'velvety', 'velveteen', 'velvetyisi', 'red velvet', 'velvetshishenmepaizikouhong', 'velvetyzenmedu', 'velva', 'velvet underground', 'velvetzenmeduyin']
Knight魔术酒吧	['knightmoshujiuba']
republic	['republic', 'republic of korea', 'republicshenmeyisi', 'republic of chinashenmeyisi', 'republic of game', 'republication', 'republiczenmedu', 'republic of singapore', 'republic mexicanyinbi', 'republic of indonesia']
huangmen	['huangma', 'huangminghao', 'huangming', 'huangmenji', 'huangmeigui', 'huangmeixi', 'huangma0-1budireci', 'huangmujingwei', 'huangmenjizuofa', 'huangmengying']
Scandal	['scandalous', 'scandal and liber', 'scanf', 'sandal', 'scandalize', 'scandium', 'scandi', 'scandicjiudian nuowei', 'scandiskshishenmeyisi']
XLKHG	['xinlunkeji', 'xiaolongkan', 'xialuoke', 'xilongkexue', 'xielongkuangbing', 'xinlongkonggu', 'xiuliankuangchao', 'xiaoliangkou', 'xialuokefu尔mosi', 'xunleikankan']
BOTTEGA	['bottegashishenmepaizi', 'botter', 'bottle', 'bottegaguanwang', 'bottom', 'botten', 'bottega veneta', 'bottero', 'bottegaxie', 'bottegaxiangbin']
DK1308	['dk13fadongjizhengshitujie', 'dk138shezhixinmima', 'dk1306fadongjizhengshitu', 'dk138menjingaimima', 'dk138bianchengmima', 'daikuan13wansannianyuehaiduoshao', 'daikuan130wan25nianzenme', 'daikuan130wanlixishiduoshao', 'dongkang13shenghefukangneigehao', 'dakai137duankou']
jinguixiaoshancheng	['jinguixiaoshancheng', 'jinguixiaoshanchengniuwa', 'jinguixiaoshancheng chunxiulu', 'jinguixiaoshanchengfendiandianhua', 'jinguixiaoshancheng(yayuncundian)zenmeyang', 'jinguixiaoshancheng(yayuncundian)', 'jinguixiaoshancheng(nanhudongludian)zenmeyang', 'jinguixiaoshancheng(guijieyidian)zenmeyang', 'jinguixiaoshanchengjiamengfeiduoshao', 'jinguixiaoshancheng(qinhuangdajiedian)zenmeyang']
zhanhouse	['zhanhou', 'zhanhouzhizhan', 'zhanhousa', 'zhanhouchuangshangzonghezheng', 'zhanhouriben', 'zhanhouyuwen', 'zhanhouxuliya', 'zhanhousakazuzuixin2019', 'zhanhou']
bodhi	['body', 'body lotion', 'bodies', 'bodyzenmedu fayin', 'boduolige', 'body washshishenmeyisizhongwenfanyi', 'body lotionshenmeyisi', 'body pumpshishenmeyundong', 'body soap', 'body lotionshishenmeyisizhongwenfanyi']
3AM-B1	['3ammeifa', '3ammeifachuangshirenjieshao', '3ammeifajianjie', '3amshenmeyisi', '3ammeifajiage', '3amzhichaojieshao', '3amlifadian', '3amgequ', '3amdadongweibo', '3amshishenme']
Cargo	['scar', 'care', 'carry', 'carrot', 'career', 'vcard', 'cartier', 'cartoon', 'cart', 'carpet']
R-kiss	['rkidshishenmeyisi', 'ruikeipgqubie', 'raidkainactive', 'cherki', 'zorki', 'aarki']
ONETHIRD	['one thirdjiuba']
njdpd	['nanjingditiexianlutu', 'nanjingdaxue', 'nanjingditietieba', 'nidemingzi', 'niujindaxue', 'nanjingdapaidang', 'nanjingditu', 'nanjingdaxuejinlingxueyuan']
LetsBURGERplus	['letsburgerplus caidan', 'letsburgerplus langang', 'letsburgerpluszenmedu', 'letsburgerplusshijiamengdianma', 'letsburgerpluswanghong', 'letsburgerplusjiage', 'letsburgerplustianjin', 'letsburgerplus shanghai']
IBIZA-B3	['ibizajuediqiusheng', 'ibiza xibanya', 'ibizashishui', 'ibiza liquid', 'ibizaweibo', 'ibizajuediqiusheng naguoren', 'ibizahuyazhibo', 'ibizadianyinjie', 'ibizajuediqiushengziliao', 'ibizashishenmeyisi']
为美好相聚沸腾	['weimeihaoxiangjufeiteng']
bajianchuan	['bajianchuqiao', 'bajianchuqiaodeyisi', 'bajianchuqiaodetexiaoshengyin', 'bajianchuan', 'bajianchuangxinrencai', 'bajianchuangxinrencaipeiyangmoshi', 'bajianchuanshuozhongdichuju', 'bajianchuanchuandebaoyushisha', 'bajianchuangxinrencaishiyanban', 'bajianchudongmen']
tongxinge	['tongxin', 'tongxinglian', 'tongxingongcheng', 'tongxinfen', 'tongxing', 'tongxingongchengzhuanye', 'tongxing', 'tongxinjishou', 'tongxin']
laotao	['laotie', 'laotou', 'laotian', 'laotaitai', 'laotoule', 'laotailongzhong', 'laotaitaigaranny', 'laotieshishenmeyisi', 'laotouyu', 'laotang']
yuebeixiaocheng	['yuebeixiaocheng', 'yuebeixiaochengfaren', 'yuebeixiaochengjindizhongxindian', 'yuebeixiaochengguanmenle', 'yuebeixiaocheng(sanlitunshimaodian)zenmeyang', 'yuebeixiaochengshimaobaihuodianzenmeyang', 'yuebeixiaocheng(shimaobaihuodian)', 'yuebeixiaocheng·chaoshanshaguozhouzenmeyang']
Berko-1	['berkoreshishenmepaizi', 'berkodangaodian']
XDHDSJ	['xiedaihudiejiededafa', 'xiandiaohoudezhuyishixiang', 'xuandehuangdi', 'xiaodiaohedadiaodequbie', 'xiduhouduojiujiancebuchulai', 'xiandanhuangdoufu', 'xuedihandaoxingxiaoshuomianfeiyuedu', 'xiedaihudiejie', 'xiandanhuangdoufudezuofa', 'xiandaihedangdaidequbie']
HighTown	['highton', 'hightongyici', 'hightongyinci', 'hightongyicizu', 'hightongyinyixingci', 'hightongyincizenmexie']
三公潮汕牛肉火锅1	['sangongchaoshanniurouhuoguosanlitundian', 'sangongchaoshanniurouhuoguosanlitun']
GoodBait	['goodbay', 'goodbayshishenmeyisi', 'goodbaywudaoshipin', 'goodbayshenmeyisizhongwen', 'goodbaywode爱renzaijian', 'goodbaiyingyuzenmexie', 'goodbaywudaogequ', 'goodbagyingwenshenmeyisi', 'goodbayzenmeduyin', 'goodbayyingyushenmeyisi']
shunshun_5G	['shunshunliuliudeyisi', 'shunshunliuxue', 'shunshunlilitupian', 'shunshunlilideshuzihongbao', 'shunshunlili', 'shunshunfengkuaididanhaochaxun', 'shunshun', 'shunshunlilidezhufuyu', 'shunshunshun', 'shunshundangdangyisi']
大龙燚火锅	['dalongyaozenmedu', 'dalongyihuoguo', 'xiaolongkan', 'dalongyaoguanwang', 'dalongyijiameng', 'dalongyicaidan', 'dalongyilaoban', 'dalongyijiamengfei', 'dalongyaoxiaolongkanneigehaochi', 'dalongyichuangshiren']
HUAXING_GUEST	['huaxinggu儿quanwenyuedu']
ANCHOR-0	['anchorshishenmeyisizhongwen', 'anchorage', 'anchornaifenzenmeyang', 'anchorageshineigechengshi', 'news anchor', 'anchornaifen', 'the anchor', 'anchorzixingche', 'anchor point', 'anchoret']
FOURACE	['fouragongsi', 'fouran', 'fouraguanggaogongsiyaoqiu', 'fouradelogo']
RestaurantY	['restaurant', 'restaurantzenmedu', 'restaurantdezhongwenyisishishenme', 'restaurantzenmeduyingyu', 'restaurant shishenmeyisi', 'restaurantshishenmeyisizhongwen', 'restaurantshishenmeyisizhongwenfanyi', 'restaurantzenmeduyinfayin', 'restaurantdeyinbiao', 'restaurantdezhongwen']
Shuilintianyue	['shuilintianyue', 'shuilintianyue歺paijiage', 'shuilintianyueshanghugaikuang', 'shuilintianyuejiuba dongdaqiao']
SWING58	['swingshenmeyisi', 'swings', 'swingzenmedu', 'swing dance', 'swingguoqushi', 'swing by', 'swimming', 'swinggongsi', 'swing jazz']
Vplus	['vpls', 'vplayer', 'vplus', 'volte', 'volvo', 'voltejibentonghuafei', 'vplusjiuba', 'vplsjishu', 'volume', 'vpliulanqishoujibanxiazai']
instyle	['instyle', 'instylezaoxing', 'instylezhongwenshishenmeyisi', 'instylezaoxingjiamubiao', 'instyleshishenmepaizi', 'instructor', 'instylechuangshiren', 'instyleshishenmeyisi', 'instyleyoujiahuabao', 'instruction']
hongyitang_n2	['hongyitangzhongyiyuan', 'hongyitang', 'hongyitangzhongyiyuanzenmeyang', 'hongyitangxiameng', 'hongyitangzhongyiyuandianhua', 'hongyitang耳bihouyanjiuyuanzenmeyang', 'hongyitang', 'hongyitang', 'hongyitang wenshide', 'hongyitangshuikeyijiamengma']
Buerjiuguan	['bu二jiuguanzenmeyang', 'bu二jiuguansisiyufan']
REDREAM	['redress', 'redream', 'redressshenmeyisi', 'regret', 'redreammoniqi安zhuoban', 'redress number', 'redreammoniqi', 'redrenzheng', 'redrestwudaojiaoxue', 'redressal']
BaseFit	['basefex', 'basefxgongsi', 'based', 'base', 'basefaze', 'basefanyi', 'basefushu', 'basefexxiazai', 'basefxhaojinma', 'basefushengtaiyishubicai']
YingLanQuanXi	['yinglanquanwudingzhizenmeyang', 'yinglanquanxiyangshengguanzhengguima', 'yinglanquanxiyangshengguanzenmeyang']
INSTYLE1	['instyle', 'instylezaoxing', 'instylezhongwenshishenmeyisi', 'instylezaoxingjiamubiao', 'instyleshishenmepaizi', 'instyleshishenmeyisi', 'instylechuangshiren', 'instylezaoxingguanwang', 'instyleyoujiahuabao', 'instylemeifachuangshiren']
COSTA2	['costco', 'costa', 'costs', 'costly', 'costcochaoshi', 'costakafei', 'costaiyizhenren', 'costguoqushi', 'custom', 'costyongfa']
Anchor	['鹌chun', '鹌chundan', '氨chajian', '暗chuang', 'anchorage', 'anchovy', '安chaoos', '鹌chundandezuofa', '按chashi', '暗chang']
pzoom	['pzoz', 'pzone', 'pzozhuanhuanbiao', 'pzozshishenmepaizi', 'pzong', 'pythonzhongos', 'paozhen呕tu', 'pszhongoverlayshenmeyisi', 'pinzhi欧lexitongmenchuang', 'puzhouo2yudajiangair']
马路牙子地桌烤肉	['maluyazidizhuokaorou(gongtidian) gaikuang', 'maluyazidizhuokaorouwangjingdian', 'maluyazidizhuokaorou(gongtidian)zenmeyang', 'maluyazidizhuokaorou(gongtidian)shanghugaikuang', 'maluyazidizhuokaoroujiameng', 'maluyazidizhuokaorou', 'maluyazidizhuokaorou(gongtidian)yonghupinglun']
pintec	['pint', 'pinterest.com', 'pintou', 'pintu', 'pintuo', 'paint', 'pinturuanjian', 'pints', 'pintzenmedu', 'pintle']
instyle02	['instylezaoxing', 'instylezaoxingjiamubiao', 'instylezhongwenshishenmeyisi', 'instyleshishenmepaizi', 'instylechuangshiren', 'instylezaoxingguanwang', 'instyleyoujiahuabao', 'instylezazhi', 'instylemeifachuangshiren', 'instyleshishenmeyisi']
3am客网	['3ammeifa', '3ammeifachuangshirenjieshao', '3amshenmeyisi', '3amdegequ', '3ammeifajianjie', '3amgeci', '3amjiefa', '3amlifadian', '3ammeifajiage', '3amoxing']
mubei	['mubiao', 'mubapei', 'mubuzhuanjing', 'mubu', 'mubuxiajie', 'mubei', 'muba', 'much', 'mubiaoguanli', 'mubushiding']
北京长虹医院	['beijingchanghongyiyuan', 'beijingchanghongyiyuanzenmeyang', 'beijingchanghongyiyuanshizhengguiyiyuanma', 'beijingchanghongyiliaomeirongyiyuanzenmeyang', 'beijingchanghongqiao', 'beijingchanghongsanreqi', 'beijingchanghongyiyuanzhengronghaoma', 'beijingchanghongyiyuanshisilidehaishiguojiade', 'beijingchanghongyiliaomeirongyiyuan', 'beijingchanghongyiyuankekaoma']
OneThird	['one thirdjiuba']
bianyifang	['pianyifang', 'pianyifangkaoya', 'pianyifangkaoyaduoshaoqianyizhi', 'pianyifangzenmedu', 'pianyifangkaoyahequanjudekaoyadequbie', 'pianyifanyici', 'pianyifangkaoyadian', 'pianyifangkaoyadianzongdiandizhi', 'pianyifangkaoyajiamubiao', 'pianyifangzongdian']
xiaozhang	['xiaozhanfuyanmoxianshen', 'xiaozhan', 'xiaozhangfu', 'xiaozhantupian', 'xiaozhang', 'xiaozhanweibo', 'xiaozhao', 'xiaozhan guyisheng', 'xiaozhang']
HUAXING	['huaxiayinhang', 'huaxicun', 'huaxiyiyuan', 'huaxianzi', 'huaxiahangkong', 'huaxigu', 'huaxiatuteng', 'huaxiaxingfu', 'huaxiong', 'huaxiangsan']
rongshangzaoxing	['rongshangzaoxing', 'rongshangzaoxing(gongtibeiluyidian)zenmeyang', 'rongshangzaoxing(gongtibeiluyidian)', 'rongshangzaoxing(gongtibeiluyidian) pinglun', 'rongshangzaoxing(gongtibeilu二dian)zenmeyang']
WX-D-one	['wanxiudou殴shijian', 'woxiangdang偶xiang', 'wuxidao欧zhoulvyou', 'wuxingde欧dun', 'wuxidi欧kafei', 'weixindeokbiaoqingbaotupian', 'wuxingde偶xiangbaokuoshenme', 'weixindeohh', 'weixindeobjshishenme', 'wangxiandeng偶尔liangyixia']
dongfangliang	['dongfanglianmeng', 'dongfangliangcaijingmijishuyouxiangongsi', 'dongfanglianmengguoshenghua', 'dongfangliangcai', 'dongfanglianmengguanfangwangzhan', 'dongfangliangcaikejiyouxiangongsi', 'dongfangliangcaizenmeyang', 'dongfanglianghuachengzhanglinghuo005616jingzhi', 'dongfanglianmengchuangshirenguoshenghua', 'dongfanglianjuexiang']
Wolfgang1	['wolfgang', 'wolfgang puck', 'wolfgangniupai', 'wolfgangshishui', 'wolfgangshenmeyisi', 'wolfgang puckmiqilin', 'wolfgang puckshishui', 'wolfgang see', 'wolfgangxiangjibaolidebu', 'wolfgang wick']
TheRug	['there', 'therefore', 'therapy', 'thermo', 'there bejuxing', 'thermos', 'thermal', 'thereby', 'therezenmedu', 'there is']
dazhangfu	['dazhang', 'dazhangwei', 'dazhangfu', 'dazhangweilaopo', 'dazhangmen', 'dazhanggui', 'dazhanggaotie', 'dazhangfuriji', 'dazhanglang', 'dazhangmen2']
shaoxiashi	['shaoxiashizongbuzainali', 'shaoxiashenmeshihou fangyan', 'shaoxiashireshuihaishilengshui', 'shaoxiashi', 'shaoxiashijiamengliansuodian', 'shaoxiashuidaoyongshenme', 'shaoxiashishenmeyisi', 'shaoxiashifuduoshaoqianyigeyue', 'shaoxiashishenmebing', 'shaoxiashishenmeyisi']
ifensi	['ifeng', 'ifengfenghuang', 'ifensi', 'ifengwang', 'sina', 'identity', 'fengzhibo', 'fengwo', 'qifengle', 'ifengfenghuangdiannaoban']
Caixin	['caixukun', 'caixin', 'caixukunweibo', 'caixukunshengri', 'caixukuntupian', 'caixia', 'caixi']
ShiTangZui	['shitangzhen', 'shitangzhuhai', 'shitangzhenyouwangonglve', 'shitangzhaonvgong', 'shitangzhuhaijingqu', 'shitangzhaobiaowang', 'shitangzhaopin', 'shitangzaocanshipu', 'shitangzainali', 'shitangzhaopinxiwangong']
东方饺子王	['dongfang jiaoziwangdianhuahaoma']
aojiameishuguanjiudian	['奥jiameishuguanjiudiandianhua', '奥jiameishuguanjiudian-dimiantingchechangzenmeyang', '奥jiameishuguanjiudianweihexiaojieduo', '奥jiameishuguanjiudianditienengdaoma', '奥jiameishuguanjiudianfancaizenyang?', '奥jiameishuguanjiudianzenmezuoditie', '奥jiameishuguanjiudianyezonghuidianhua', '澳jiameishuguanjiudiandixiaKTVjiaoshenme', '奥jiameishuguanjiudian(dongzhimenwaidajie26hao)']
sushitong	['sushitong', 'sushitong', 'sushitongshidaishirenyouneixie', 'sushitouguxunzhengjiamengfei', 'sushitongkejinshiyouneixie', 'sushitongnianlicuicandemingzhu', 'sushitouxiangtupiandaquan', 'sushitong simu', 'sushitong', 'sushitouxiangdejianbihua']
hooters2	['hooters', 'hooterscanting', 'hootersmaotouyingcanting', 'hootersshishenmeyisi', 'shooter', 'hooterslujiazui', 'hooterscantingyingyezhuangkuang', 'hootershishenmeyisi啊', 'gun shooter', 'cfjilinyiqushooter']
rampage	['rampage', 'rampant', 'rampart', 'rampantshenmeyisi', 'rampageshishenmeyisi', 'rampancy', 'rampagedianying', 'rampal', 'rampant ascendance', 'rampageshishenmepaizi']
Velvet	['velvet', 'velvety', 'velveteen', 'velvetyisi', 'red velvet', 'velvetshishenmepaizikouhong', 'velvetyzenmedu', 'velva', 'velvet underground', 'velvetzenmeduyin']
bookworm	['bookworm', 'bookwormshishenmeyisi啊', 'bookwormzenmedu', 'bookworm beijing', 'bookwormguanwang', 'bookworm oxford', 'bookwormshigebianyicima', 'bookwormshuchongxilie']
instyle2	['instyle', 'instylezaoxing', 'instylezhongwenshishenmeyisi', 'instylezaoxingjiamubiao', 'instyleshishenmepaizi', 'instyleshishenmeyisi', 'instylechuangshiren', 'instylezaoxingguanwang', 'instyleyoujiahuabao', 'instylemeifachuangshiren']
HUAZHU_Hanting	['huazhuhantingdemimashishenme', 'huazhuhanting', 'huazhuhantingningbo', 'huazhuhantingjiudianwifimima', 'huazhuhantingsuofeiya', 'huazhuhantingjiudianshujuxielou', 'huazhuhantingwifimima', 'huazhuhantingwifimimarenzheng', 'huazhuhantingjiudian', 'huazhuhantingguanwang']
HaiDiLaoDianCai	['haidilaodiancanjiqiao', 'haidilaodiancaidoushiipad', 'haidilaodiancan', 'haidilaodiancanxitong', 'haidilaodiancangonglve', 'haidilaodiancaidepingbanzayong', 'haidilaodiancai', 'haidilaodiancaigonglve', 'haidilaodiancaigonglve2ren', 'haidilaodianzhangriji']
请晋山西餐社	['qingjinshanxicanshezenmeyang', 'qingjinshanxicansheqiaojiadayuan', 'qingjinshanxicanshe(haoyunjiedian)zenmeyang', 'qingjinshanxicanshe(sanlitunshiguanglieche)zenmeyang', 'qingjinshanxicanshe(haoyunjiedian)', 'qingjinshanxicanshelaoban', 'qingjinshanxicanshesanlitun', 'qingjinshanxicanshejiameng']
Algorithm	['algorithm', 'algorithmic', 'algorithmshishenmeyisi', 'algorithmhanshu', 'algorithmfanyi', 'algorithmtouwenjian', 'algorithm negotiation fail', 'algorithmic trading', 'algorithmzenmedu', 'algorithmicshenmeyisi']
haolinju	['haolingtianxiashoujihaomaceji', 'haolingtianxia', 'hailingdao', 'haolin', 'haolingtianxiashoujihaomacejixiong', 'haolin', 'haolin', 'haoling', 'haolingdao', 'haolinju']
F-SPACE	['fangshipin安quanjiaoyujilu', 'fengshupi熬shuikeyihema', 'foshanping安chexianyingyeting', 'fenshoupiaxiwenben', 'foshanping安yinhangdizhichaxun', 'fashipingazuidashuchu', 'fusongping安baoxiangongsidizhi', 'fengshunping安xinwen', 'foshanping安baoxianwangdianchaxun', 'fashaopao艾caoyuyouxiaoguoma']
buerjiuguan2	['bu二jiuguanzenmeyang', 'bu二jiuguansisiyufan']
wangjingxiaoyao	['wangjingxiaoyaojiamengduoshaoqian', 'wangjingxiaoyaotupian', 'wangjingxiaoyaoshishenmeyaozi', 'wangjingxiaoyaozuofa', 'wangjingxiaoyaozongdianzaina', 'wangjingxiaoyao', 'wangjingxiaoyaozenmeyang', 'wangjingxiaoyaonajiashizhende', 'wangjingxiaoyaozongdian', 'wangjingxiaoyaojiameng']
cafeflo	['caffeine', 'caffekuangjia', 'caffeineshenmeyisi', 'cafefayu', 'cafefanyi', 'caffehecoffeequbie', 'caffeshishenmeyisi啊', 'caffeinism', 'caffeine anhydrous', 'caffeineshishenmeyao']
WALA1	['walk', 'wall', 'wallet', 'walrus', 'walking', 'walnut', 'walked', 'wa liyuchun', 'walkman', 'walt']
Mojitoman	['mojitomoxigecanting', 'mojitomenshaobeizenmeyang', 'mojitomojituo']
yinyuetai.com	['yinyuetaichangzenmejianduan', 'yinyuetaichangzenmejianjishouji', 'yinyuetaichuangshiren', 'yinyuetaichejiban', 'yinyuetaichangzenmejianqie', 'yinyuetaichejipojieban', 'yinyuetaichangzenmexiujianyinyue', 'yinyuetaichuangshirenshiying', 'yinyuetaichaoshijuleida', 'yinyuetaicaifangzhangyixing']
Revolution5G	['revolutionary', 'revolutionjitapu', 'revolutionshishenmeyisi', 'revolutionjita', 'revolutionjiaoxue', 'revolutionzhitan', 'revolutiongeci', 'revolutiongequ', 'revolution ct', 'revolutionxiazai']
thebell	['thebes', 'thebest', 'thebezshoubiaoshishenmepaizi', 'thebestshishenmepaizi', 'thebez', 'thebeatshenmeyisi', 'thebendingshiqiruheshezhi', 'the best is for youshenmeyisi', 'thebee', 'thebestshenmeyisi']
Revolution	['revolution', 'revolutionary', 'revolutionjitapu', 'revolute', 'revolutionshishenmeyisi', 'revolutionjitawangyiyun', 'revolutionjitayinpin', 'revolution one', 'revolutionzhitanmp3', 'revolutionfaguopinpai']
yigonglihaixianfang	['yigonglihaixianfangshanghugaikuang', 'yigonglihaixianfangyonghupinglun', 'yigonglihaixianfangwangyoupinglun']
珍滋味港式粥火锅	['zhenziweigangshizhouhuoguocaidan', 'zhenziweigangshizhouhuoguo(gongtidian)', 'zhenziweigangshizhouhuoguojiameng', 'zhenziweigangshizhouhuoguo(xinyuanxilidian)zenmeyang', 'zhenziweigangshizhouhuoguoguanwang', 'zhenziweigangshizhouhuoguozenmeyang', 'zhenziweigangshizhouhuoguo(gongtidian)shanghugaikuang', 'zhenziweigangshizhouhuoguojiage', 'zhenziweigangshizhouhuoguo(gongtidian)wangyoupinglun', 'zhenziweigangshizhouhuoguo xinyuanlidian']
WeWork	['wework', 'weworkshanghai', 'weworkbeijing', 'weworkshishenmegongsi', 'weworkguanwang', 'weworkshenzhen', 'weworkrongziyi', 'rework', 'weworkzhaopin', 'weworkchengdu']
THERUG	['there', 'therefore', 'therapy', 'thermo', 'there bejuxing', 'thermos', 'thermal', 'thereby', 'therezenmedu', 'there is']
WALA2	['walk', 'wall', 'wallet', 'walrus', 'walking', 'walnut', 'walked', 'wa liyuchun', 'walkman', 'walt']
STAFOOD	['stafood', 'stafoodmianguanwushuangzenmeyang', 'stafoodmianguanwushuangguanwang', 'staforunhuayou', 'stafoodmianguanwushuangcaidan']
ONSTAR	['onstage', 'onstar', 'const', 'onste', 'onstagedeyisi', 'instead', 'onstarxitong', 'instrument', 'onsteshishenmeyisi', 'onstart']
C5cafe	['c5caipiaoxiazai安zhuang', 'c5canjirenkeyikaojiazhaoma', 'c5canshu', 'c5canjirennengkainajizhongche', 'c5canjirenzidongdangqiche', 'c5canjirenzhuanyongchetupian', 'c5caogang', 'c5caipingzhinengshouhuan', 'c5canjicheshishenmeche']
IBIZA	['ibiza', 'ibis', 'ibil', 'ibizajuediqiusheng', 'ibid', 'ibiza耳ji', 'ibike', 'ibiden', 'ibizashezhi', 'ibizaweibo']
rich-healthcare	['rich-healthcare.', 'rich-healthcarecm', "rich-healthcarecom~911100560120yi395E'"]
didiao2	['didiaozuhe', 'didiaokan', 'didiaokanzhibo', 'didiaotupian', 'didian', 'didiaozuhechengrenshiqinglv', 'didian', 'didiaogaoshou', 'didianfuci', 'didiaoshehua']
PizzaNow	['pizzano', 'pizzanengfangduojiu', 'pizzanengfangyitianma', 'pizzaneigehaochi', 'pizzanengbunengdi二tianchi', 'lipizzan']
Jindingxuan	['jindingxuan', 'jindingxuan二gongzidafan', 'jindingxuancaidan', 'jindingxuan二gongzi', 'jindingxuanditandian', 'jindingxuancaidanjijiage', 'jindingxuanyonghegongdiandizhi', 'jindingxuan24xiaoshiyingye', 'jindingxuantuanjiehudian', 'jindingxuanfangzhuangdiandianhua']
jindingxuan	['jindingxuanyonghegongdiandizhi', 'jindingxuan二gongzi', 'jindingxuancaidan', 'jindingxuanditandian', 'jindingxuan', 'jindingxuan24xiaoshiyingye', 'jindingxuanfangzhuangdiandianhua', 'jindingxuancaidanjijiage', 'jindingxuantuanjiehudian', 'jindingxuan二gongzidafan']
xiaotudou...	['xiaotudouzenmezuohaochi', 'xiaotudoudezuofa', 'xiaotudou', 'xiaotudouxiancaidezuofa', 'xiaotudounaipingzenmeyang', 'xiaotudoukou奥ni尔shipin', 'xiaotudouzenmequpi', 'xiaotudougekou奥ni尔shipin', 'xiaotudounaiping', 'xiaotudoudezuofadaquanjiachang']
qiaowaipo	['qiaowaiyimin', 'qiaowaichuguo', 'qiaowaizui5.5xiuxianshipinjiamengduoshaoqian', 'qiaowaizui5.5xiuxianshipinzenmeyang', 'qiaowaizui6.6', 'qiaowaiyiminzhengguima', 'qiaowaipomalaxiangguotieyingqiao', 'qiaowaizuixiuxianshipinjinjiabiao', 'qiaowaizuixiuxianshipinjiameng', 'qiaowaizuishipinjiamengpianju']
Honda	['honey', 'honor', 'honest', 'hongmeng', 'honghuahui', 'hongqi', 'hongdou', 'hongloumeng', 'hongshaorou', 'hongmen']
zhengyuanyuan	['zhengyuanyuan', 'zhengyuanyuan', 'zhengyuanyuanzhuanyexiujiaofang', 'zhengyuanyuanzhuanyexiujiaofangjiameng', 'zhengyuanyuanzhihuizhijiazhenshima', 'zhengyuanyuanzhuanyexiujiaofangfujin', 'zhengyuanyuanzhuanyexiujiaofangzenmeyang', 'zhengyuanyu432', 'zhengyuanyuanxiujiaofangjiagebiaotu', 'zhengyuanyuanzhuanyexiujiaodian']
@百万庄园方庄店	['baiwanzhuangyuanfangzhuangdian']
方庄物业大厦	['fangzhuangwuyedianhuahaoma', 'fangzhuangwuyegongsidianhua', 'fangzhuangwuyeweixiudianhuahaoma', 'fangzhuangwuyediyifengongsi', 'fangzhuangwuyeweixiudianhua', 'fangzhuangwuyeguanligongsi', 'fangzhuangwuyedonghuijiayuandianhua', 'fangzhuangwuyekefu', 'fangzhuangwuyetousudianhua', 'beijingfangzhuangwuye']
xiaotudou..	['xiaotudou', 'xiaotudoudezuofa', 'xiaotudouzenmezuohaochi', 'xiaotudouqupi', 'xiaotudouxiancaidezuofa', 'xiaotudounaipingzenmeyang', 'xiaotudouxiancai', 'xiaotudouyingwen', 'xiaotudounba', 'xiaotudoushishui']
小龙坎老火锅	['xiaolongkanlaohuoguo', 'xiaolongkanlaohuoguoshiyonglaoyou', 'xiaolongkanlaoyoufanfuyongshipin', 'xiaolongkanlaoyoufanfuyong', 'xiaolongkanlaohuoguohuishouyou', 'xiaolongkanlaohuoguoshijian', 'xiaolongkanlaohuoguohouchu', 'xiaolongkanlaohuoguojiamengfei', 'xiaolongkanlaohuoguozenmeyang', 'xiaolongkanlaohuoguoguanwang']
味多美刘家窑地铁店	['weiduomeiliujiayaoditiedian']
CNODDT	['cnodc', 'cnode', 'cnodcdequanchengshishenme', 'cnodcxifeigongsi', 'cnodczhaopin', 'cnodchaiwaibankuai', 'cnodczhaopinyouyinweitijian', 'cnodcneibuzhaopinbishi', 'cnodcyibashou', 'cnodcyuzhongyouguojiguanxi']
LAOBAOSAN	['laobaosan', 'laobaosandezuofa', 'laobaosuo', 'laobaoshoutao', 'laobaoshishenmeyisi', 'laobaosuoshiganshenmede', 'laobaoshoutaopifajiage', 'laobaoshishenmeyisi', 'laobaoshishenmeniao', 'laobaosanshishenme']
99inn	['motorola mt99i', 'zujin999i', 'zhoudafuzujin999i', 'sanxingi699i', '99imgzenmeyong', '99img', 'c122699i', '99ishishenmeyisi', '99innwuxianwangdenglu', '99inn.cc']
鸿运天外天	['hongyuntiancheng', 'hongyuntianchengshenmeyisi', 'hongyuntianqiao', 'hongyuntianjiangluyuan', 'hongyuntianjiangxiaoshuo', 'hongyuntianwaitiankaoyadian', 'hongyuntianchenggongsi', 'hongyuntianchengzhegechengyujieshi', 'hongyuntianlangxingsantou', 'hongyuntianchenghuadeyuyi']
dawanju	['dawan', 'daiwangka', 'dawanqu', 'dawankuanmian', 'daiwangraoming', 'daiwang', 'dawanjia', 'daiwangshe', 'daiwanghua', 'dawan']
YLKYD	['yuanlaike', 'yilake', 'yilaikesi', 'yilakezhanzheng', 'yuanlaikeshoujidengluhuiyuan', 'yuanlikeji', 'yuelaikezhan', 'yinglunka', 'yilaikesikongtiao', 'yilaikesibingxiang']
Yoshinoya	['yoshinohaoxunyangjian', 'yoshinoriyushishenme', 'yoshinoshishenmeyisi', 'yoshinoxunyangjian', 'ribenyoshino', 'yoshinojiye', 'yoshinozhanjianshijie']
ChunBingKaoYaDian	['chunbingkaoyadian', 'chunbingkaoyadian(liujiayaoshunsantiaodian)zenmeyang', 'chunbingkaoyadian(liujiayaoshunsantiaodian)', 'chunbingkaoyadiantuijianshunsitiao', 'chunbingkaoyadianliujiayaodian', 'chunbingkaoyadiandedianhuahaoma?', 'chunbingkaoyadian(fangzhuangdian)zenmeyang']
Laochengyiguo	['laochengyiguo', 'laochengyiguoyangxiezi', 'laochengyiguoyangxiezijiameng', 'laochengyiguoyangxiezihuoguojiamengfeiduoshao', 'laochengyiguoyangxiezi', 'laochengyiguoyangxiezizuofa', 'laochengyiguohelaochengyiguo', 'laochengyiguoyangxiezijiamengfeiduoshao', 'laochengyiguoyangxiezihuoguojiameng', 'laochengyiguodianhua']
ZGGJWJY	['zhongguogejuwujuyuan', 'zhongguogejuwujuyuankaojizhengshuyouxiaoma', 'zhuangguguanjiewan', 'zhongguoguojiweishenmenanru', 'zhongguogejuwujuyuankaoji', 'zhongguogejuwujuyuankaojizhengshuchaxun', 'zhuangguguanjiewandegongxiaoyongtu', 'zhongguoguojiwenhuachuanbozhongxin', 'zhongguoguojiwentiyanjiuyuan', 'zhongguoguojiaweilaidemingpian']
HaiYinHaiJi	['haiyinhaiji', 'haiyinhaijichaoshanhuoguo', 'haiyinhaijichaoshanniurouhuoguo', 'haiyinhaijicaidan', 'haiyinhaijidianhua', 'haiyinhaijiniurou', 'haiyinhaijishangshilema', 'haiyinhaijibaoshan', 'haiyinhaiji meigu', 'haiyinhaiyingufenguba']
7daysinn	['7daysin']
诚记鲜牛肉火锅	['chengjixianniurouhuoguo']
Sinopec	['sinopec', 'sinopecshishenmeyisi', 'sinopay', 'sinopac', 'sinopecsales.co m', 'sinopecquancheng', 'sinope', 'sinoped', 'sinophile', 'sinoppe']
北京何所有酒店	['beijinghesuoyoujiudiandianhua', 'beijinghesuoyoujiudianliujiayao', 'beijinghesuoyoujiudianzenmeyang', 'beijinghesuoyoujiudiandizhi', 'beijinghesuoyoujiudian jixing', 'beijinghesuoyoujiudianzhaopin', 'beijinghesuoyoujiudiandaobeijingnanzhandache', 'beijinghesuoyoujiudiantupian', 'beijinghesuoyoujiudian nanzhan']
bingchengBBQ	['binchengbihua', 'binchengbihuajiedizhi', 'bingchengbuwangchuxinlaojishiming', 'binchengbihuajie', 'binchengbaigalimian', 'binchengbaikafeizenmeyang', 'binchengbihuaditu', 'bingchengbaodeyingwen', 'binchengbihuajizhongzainali', 'binchengbaidubaike']
dinghaishenzhen	['dinghaishenzhen', 'dinghaishenzhenqingpingzhuanyongchaochang', 'dinghaishenzhenshuaping', 'dinghaishenzhenbiyushenmeyisi', 'dinghaishenzhenshichengyuma', 'dinghaishenzhen', 'dinghaishenzhentupian', 'dinghaishenzhenruanjian', 'dinghaishenzhu', 'dinghaishenzhenshishenmeyisi']
julongwatankaoyangtui1	['julongwatankaoyangtui(pinggudian)(pinggudian)zenmeyang', 'julongwatankaoyangtui(linjiangdian)zenmeyang', 'julongwatankaoyangtui(jingdongqijiandian)zenmeyang', 'julongwatankaoyangtui(liujiayaodian)shanghugaikuang', 'julongwatankaoyangtuijingdongqijiandianzenmeyang', 'julongwatankaoyangtui(jichangdian)zenmeyang', 'julongwatankaoyangtui(zhengzhouzongdian)zenmeyang', 'julongwatankaoyangtui(liujiayaodian)zenmeyang']
fengmaokaochuan-2	['fengmaokaochuan', 'fengmaokaochuanjiameng', 'fengmaokaochuanguanwang', 'fengmaokaochuanjiamengfeiduoshaoqian', 'fengmaokaochuanzongdian', 'fengmaokaochuanquanguofendiandizhi', 'fengmaokaochuanjiamengguanwang', 'fengmaokaochuandianhua', 'fengmaokaochuandongtiandianneijingyingshipin', 'fengmaokaochuanjiamengfeiduoshao']
丰茂烤串5	['fengmaokaochuan', 'fengmaokaochuanjiameng', 'fengmaokaochuanguanwang', 'fengmaokaochuanjiamengguanwang', 'fengmaokaochuandianhua', 'fengmaokaochuandongtiandianneijingyingshipin', 'fengmaokaorou', 'fengmaokaochuanjiamengfeiduoshaoqian', 'fengmaokaochuanquanguofendiandizhi', 'fengmaokaochuanzongdian']
丰茂烤串6	['fengmaokaochuan', 'fengmaokaochuanjiameng', 'fengmaokaochuanguanwang', 'fengmaokaochuanjiamengguanwang', 'fengmaokaochuandianhua', 'fengmaokaochuandongtiandianneijingyingshipin', 'fengmaokaorou', 'fengmaokaochuanjiamengfeiduoshaoqian', 'fengmaokaochuanquanguofendiandizhi', 'fengmaokaochuanzongdian']
ZGTLGJ	['zhongguotielu', 'zhongguotieluzonggongsi', 'zhongguotielurencaizhaopinwang', 'zhongguotieluwang', 'zhongguotielu12306', 'zhongguotieluditu', 'zuogaotieliucheng', 'zhongguotielukehufuwuzhongxin', 'zigongtuoluoyoushenmezhengzhuang', 'zhongguotieluju']
fengmaokaochuan_5G	['fengmaokaochuan', 'fengmaokaochuanjiameng', 'fengmaokaochuanguanwang', 'fengmaokaochuanjiamengfeiduoshaoqian', 'fengmaokaochuanzongdian', 'fengmaokaochuanquanguofendiandizhi', 'fengmaokaochuanjiamengguanwang', 'fengmaokaochuandianhua', 'fengmaokaochuandongtiandianneijingyingshipin', 'fengmaokaochuanjiamengfeiduoshao']
hanlinkaorou	['hanlinkaorou', 'hanlinkaorou']
丰茂烤串2	['fengmaokaochuan', 'fengmaokaochuanjiameng', 'fengmaokaochuanguanwang', 'fengmaokaochuanjiamengguanwang', 'fengmaokaochuandianhua', 'fengmaokaochuandongtiandianneijingyingshipin', 'fengmaokaorou', 'fengmaokaochuanjiamengfeiduoshaoqian', 'fengmaokaochuanquanguofendiandizhi', 'fengmaokaochuanzongdian']
国投商务酒店	['guotoushangwuzhongxin', 'guotoushangwujiudianwuxianwangmima']
tangquanliangzi	['tangquanliangzi', 'tangquanliangzijiamubiao', 'tangquanliangzizenmeyang', 'tangquanliangzijiameng', 'tangquanliangziguanwang', 'tangquanliangzijianguomendian', 'tangquanliangzilaiguangyingdian', 'tangquanliangzibeiyuandiandizhi', 'tangquanliangziyouneixiexiangmu', 'tangquanliangzijiamengfeiduoshao']
不老溪老菜馆1	['bulaoxilaocaiguan(rongfengdian)zenmeyang', 'bulaoxilaocaiguanzenmeyang']
骏怡连锁酒店	['junyiliansuojiudian', 'junyiliansuojiudianjiage', 'junyiliansuojiudianjianjie', 'junyiliansuojiudiandianhua', 'junyiliansuojiudiantousudianhuaduoshao', 'junyiliansuojiudianweizhi', 'junyiliansuojiudianappxiazai', 'junyiliansuojiudianfenghelu', 'junyiliansuojiudianguanwangapp', 'junyiliansuojiudianshijixingji']
zhangqiuhaitai	['zhangqiuhaitaishifucaidanjiage', 'zhangqiuhaitunwanbinguan', 'zhangqiuhaitai', 'zhangqiuhaitunwanmeijiadiandianhua', 'zhangqiuhaitaijituanzhangjianjun', 'zhangqiuhaitiejianshen', 'zhangqiuhaitiejianshenfangzenmeyang', 'zhangqiuhaitunwanqijiandiandianhua', 'zhangqiuhaitangxiaozhu', 'zhangqiuhaitaijituanfulidaiyu']
yunhuisuo	['yunhuishouzhanhuifudezhaopianzainazhao', 'yunhuishishenmedianshijurenwu', 'yunhuiseshishenmeyanse', 'yunhuishi', 'yunhuishishenmechengyu', 'yunhuishidizhuanxiaoguotu', 'yunhuisuo', 'yunhuishouzhan', 'yunhuishi', 'yunhuise']
fengmaokaochuan	['fengmaokaochuan', 'fengmaokaochuanjiameng', 'fengmaokaochuanguanwang', 'fengmaokaochuanjiamengfeiduoshaoqian', 'fengmaokaochuanzongdian', 'fengmaokaochuanquanguofendiandizhi', 'fengmaokaochuanjiamengguanwang', 'fengmaokaochuandianhua', 'fengmaokaochuandongtiandianneijingyingshipin', 'fengmaokaochuanbeijingshidian']
bulaoxilaocaiguan	['bulaoxilaocaiguan(rongfengdian)zenmeyang', 'bulaoxilaocaiguanzenmeyang']
podinns	['podingfangwuzhuangxiuxiaoguotu', 'podingdefangzibuyizhuren', 'poding', 'podingfangwutupian', 'podingdan', 'podingdanshishenmeyisi', 'podingshanhongcha', 'podingdiantingcheduidian', 'podingxiaoguotu', 'podingshenmeyisi']
CHAOZHOUHUI	['chaozhouhua', 'chaozhouhuafanyi', 'chaozhouhuazaixianfayin', 'chaozhouhengxingshuishangleyuan', 'chaozhouhanwengongci', 'chaozhouhanwengongmiaobei', 'chaozhouhechaoshandequbie', 'chaozhouhanshanshifandaxue', 'chaozhouhuamarenjingdiande100ju', 'chaozhouhengdaicheng']
NOVOTEL	['novotel', 'novoteljiudianjixing', 'novotelshishenmeyisi', 'novoteljiudian', 'novoteljiudian shanghai', 'novotek', 'novotelshanghai', 'novotelxinjiapo', 'novoteltaiguo', 'novotelshou尔']
siyeniula	['siyeniulashiqingzhendema', 'siyeniulazongdianzaina', 'siyeniulachuangshiren', 'siyeniulachuangshirenwuxihua', 'siyeniulamianmendian', 'siyeniuhuluxiaoshuo', 'siyeniula']
hehuatai	['hehuatouxiang', 'hehuatu', 'hehuatang', 'hehuating', 'hehuatupiandaquan gaoqing', 'hehuatouxiangtupian weixin', 'hehuatedian', 'hehuatupianshouhui jianbihua', 'hehuatupiandaizi', 'hehuatouxiangdaibiaoshenmeyisi']
jiangtaiwuer	['jiangtaiwu二beijingdian', 'jiangtaiwujiameng', 'jiangtaiwu二caidanjiamubiao', 'jiangtaiwu二shenmedangci', 'jiangtaiwu二', 'jiangtaiwu', 'jiangtaiwu二shenmeyisi', 'jiangtaiwu二jiamengfei', 'jiangtaiwu二shizizhuma', 'jiangtaiwu二caidan']
Joyinn	['joying', 'joyice', 'joyingshenmeyisi', 'jiyizhonggou', 'joyins', 'joyingwenming', 'joyizenmedu', 'joyinn', 'joyishishenmeyisizhongwen', 'joyingwuyangbentian']
戈拿旺巴西烤肉	['genawangbaxikaorouzizhucan', 'genawangbaxikaoroucaishikoudian', 'genawangbaxikaoroujiaqian', 'genawangbaxikaoroutuangou', 'genawangbaxikaoroubiaoyan', 'genawangbaxikaorouyayuncun', 'genawangbaxikaorou(yayuncunzhiyingdian)zenmeyang', 'genawangbaxikaorou(chongwenmendian)', 'genawangbaxikaorou(yayuncunzhiyingdian)', 'genawangbaxikaorou(caishikoudian)shanghugaikuang']
Guangming-Daily	['guangmingdaimamishitaotuogonglve', 'guangmingdaimamishitaotuo', 'guangmingdaiyanren', 'guangmingdaima', 'guangmingdaimamishitaotuoyishidebaozanggonglve', 'guangmingdaiwangye', 'guangmingdaizhuangsuanniunai', 'guangmingdaibiaoshenme', 'guangmingdaiwangyeshangbiao', 'guangmingdaima yishidebaozang']
McDonald's	['maidanglao']
hankoujietou	['hankoujietou', 'hankoujietou taiyanggong', 'hankoujietou guoruichengdian', 'hankoujietou dazhongdianping']
Novotel-XinQiao	['novotelxinqiaojiudian']
DingJunHui	['dingjunhui', 'dingjunhui2019zuixinbisai', 'dingjunhuizuixinbisaixiaoxi', 'dingjunhuiba', 'dingjunhuibisai', 'dingjunhuizhibo', 'dingjunhui2019zuixinpaiming', 'dingjunhui147']
tiancifuyuan1	['tiancifuyuan', 'tiancifuyuanshishenmeyisi', 'tiancifuyuanjiudianzenmeyang', 'tiancifuyuansiheyuanjiudian']
Super8	['super', 'super junior', 'superior', 'supermarket', 'superb', 'superman', 'superm', 'supervision', 'superficial', 'superhero']
hankunlaw	['hankunlvshishiwusuo', 'hankunlvshishiwusuopaiming', 'hankunlvshishiwusuoliudong', 'hankunliqikuangfei', 'hankunlvsuo geyin', 'hankunlvsuosanweichuangshiren', 'hankunlvshi', 'hankunlvshishiwusuoguanwang', 'hankunli二daidiaoyugan', 'hankunlvshishiwusuodaiyu']
mingshiguang	['mingshiguang', 'mingrihua', 'mingshiguangyankeyiyuan', 'mingshiguangyankeyiyuanhaobuhao', 'mingshiguanye', 'mingshiguanwang', 'mingshiguangyankeyiyuandizhi', 'mingshiguai', 'mingshiguangyankeyiyuandianhua', 'mingshiguandi']
yunhaiyao	['yunhaiyugongyuanzaixianguankan', 'yunhaiyao', 'yunhaiyuan', 'yunhaiyugongyuan20jiguoyu', 'yunhaiyugongyuanxiaoshuoyuedu', 'yunhaiyaochuangshiren', 'yunhaiyugongyuanxiaoshuo', 'yunhaiyaocaidan', 'yunhaiyugongyuan', 'yunhaiyugongyuandianshiju']
huachengshishang	['huachengshishangjiudian', 'huachengshishangjiudiandizhi', 'huachengshishangjiudian', 'huachengshishangjiudiandeditu', 'huachengshisha', 'huachengshishangbinguanzenmeyang', 'huachengshishangjiudianzenmeyang', 'huachengshishangjiudianzenmeyang', 'huachengshishangjiudian(beijingchongwenmenditiezhandian)zenmeyang', 'huachengshishangzizhuhuoguochengzenmeyang']
99inn.cc	['99inn.cc', '99innwuxianwangdenglu']
BlueNoteBJ	['blue note beijing', 'blue note jazz club', 'blue note shanghai', 'blue note beijingguanwang', 'blue notesxiangshui', 'blue note jazz beijing', 'blue notesxiangshuiduoshaoqian', 'blue note shanghaidizhi', 'blue noteshishenmeyisi', 'blue notes jueshi']
rongchengguli	['rongchenggujie', 'rongchenggulangyuxiyubannali', 'rongchengguicheng', 'rongchengguojidanyang', 'rongchengguoji', 'rongchengguojihaishuiyuchang', 'rongchengguangdiankuandaikefudianhua', 'rongchengguangchang', 'rongchengguojitengzhouzuixinxiaoxi', 'rongchengguoyonghuaijinianguan']
便宜坊哈德门店	['pianyifanghademendiandianhua', 'pianyifanghademen', 'pianyifanghademenzenmeyang', 'pianyifanghademendianditie', 'pianyifanghademenkaoyadianzenmeyang', 'pianyifanghademendiantesecai', 'pianyifanghademendianxuyaopaiduibu', 'pianyifanghademendiandizhi', 'pianyifanghademenhexinshijiedian']
Novotel_XinQiao	['novotelxinqiaojiudian']
beautyfarm	['beautyfanyi', 'beautyfanyizhongwen', 'beautyfayin', 'beautyfangshaishuangpaiming']
FamilyMart	['familymanhua']
BlueNote	['blue note beijing', 'bluenongxianghedanxiangdequbie']
wendingfu	['wending', 'wendingzhongyuan', 'wending', 'wendingqi', 'wendingdianfeng', 'wendingxing', 'wending', 'wendingjianghu', 'wendingji', 'wendingdeyingwen']
fenglianbinguan	['fenglianbinguan']
HuoLuHuo	['huoluhuojiamengfei', 'huoluhuozizhuduoshaoqian', 'huoluhuocaidan', 'huoluhuonianshenme', 'huoluhuo', 'huoluhuozizhushisuibiandianma', 'huoluhuikeyizhijietulianma', 'huoluhuonanguazhoudezuofa', 'huoluhuozizhu', 'huoluhuokaorou']
99inn.cn	['99inn.cc', '99innwuxianwangdenglu']
dadongkyd	['dadongkaoyadian', 'dadongkaoyaduoshaoqianyizhi', 'dadongkaoyadiancaidanjiagebiao', 'dadongkaoyadiandizhi', 'dadongkaoyadianrenjunxiaofei', 'dadongkaoyadianjiamubiao2019', 'dadongkaoyadiangongtidiandizhi', 'dadongkaoyacaidan', 'dadongkaoyagongtidian']
tiancifuyuan3	['tiancifuyuan', 'tiancifuyuanshishenmeyisi', 'tiancifuyuanjiudianzenmeyang', 'tiancifuyuansiheyuanjiudian']
ciming	['cimi', 'cimingtijian', 'cimic', 'cimingtijianzhongxin', 'ciming', 'ximi', 'cimit', 'cimilre', 'cimingtijiandianhua', 'ciming']
tangchaoktv	['tangchaokaiguohuangshang', 'tangchaokaiguogongchen', 'tangchaokuijia', 'tangchaokuxing', 'tangchaokaiguomingjiang', 'tangchaoktv', 'tangchaokejuzhidu', 'tangchaokaiyuanshengshi', 'tangchaoktv', 'tangchaokaifang']
zizhuyezonghui2	['zizhuyezonghuishiganmade', 'zizhuyezonghuixilian', 'zizhuyezonghuixiaofeishuiping', 'zizhuyezonghuishijibai', 'zizhuyezonghuihaowanma', 'zizhuyezonghuixizhimen', 'zizhuyezonghuiwangxinyue']
zizhuyezonghui8	['zizhuyezonghuishiganmade', 'zizhuyezonghuixilian', 'zizhuyezonghuixiaofeishuiping', 'zizhuyezonghuishijibai', 'zizhuyezonghuihaowanma', 'zizhuyezonghuixizhimen', 'zizhuyezonghuiwangxinyue']
北京市党派团体办公楼	['beijingshidangpaituantibangonglou', 'beijingshidangpaituantibangongloufuwuguanlizhongxin']
MeiNianDaJianKang	['meiniandajiankangtijiankexinma', 'meiniandajiankangguanwang', 'meiniandajiankang', 'meiniandajiankangtijianzhongxinbaogaochaxunapp', 'meiniandajiankangzhaopin', 'meiniandajiankangtijianzhongxin', 'meiniandajiankangtijianzhongxinguanwangchakanbaogao', 'meiniandajiankangtijianzhongxindianhua', 'meiniandajiankangtijianzhongxinzenmeyang', 'meiniandajiankanggupiao']
juelvbang	['juelvbang']
lashangyin	['lashangyin', 'lashangyongshenmeyao', 'lashangyinkaoyu', 'lashangyindaili', 'lashangyaobuzenmebanhuifukuai', 'lashangyinmalaxiangguojiamengfeiduoshao', 'lashangyongshenmegaoyaobijiaohao', 'lashangyinxiaochi', 'lashangyongbingfuhaishirefu', 'lashangyinjiameng']
acfic	['acfun', 'acfuntanmushipinwang', 'acg', 'ace', 'acfjiao', 'acei', 'acfta', 'cfa', 'acfm', 'acfunjixiangwu']
nongtangli	['nongtang', 'longtang', 'nongtangbao', 'nongtangbaoduishentiyouhaima', 'longtangxiaolongbao', 'longtangjiyi', 'nongtangzenmezuo', 'nongtang', 'longtangshishenmeyisi', 'nongtang']
CECEP	['cecilia', 'cect', 'ceci', 'cece', 'cecil', 'cecile', 'ceckongzhi', 'cecshishenmeyisi', 'cecs']
Tai_Shu_Xi	['taishuganhai', 'taishuntianqi', 'taishuntianqiyubao', 'taishuganhaishipin', 'taishuganhaibaijiahao', 'taishuda', 'taishun', 'taishudashuomingshu', 'taishuxijiachangcai', 'taishu']
yunledi	['yunle', 'yunleizaoxing', 'yunleiwen', 'yunleicuan', 'yunlei', 'yunle', 'yunleizaoxingdizhi', 'yunleihui', 'yunleitianyu']
shuimumicheng	['shuimumichengmishitaotuogonglve']
Sizzler	['sizzle', 'sizzler', 'sizzlercanting', 'sizzlershenmeyisi啊', 'sizzleshishenmeyisi啊', 'sizzlershishenmecai', 'sizzle it your way', 'sizzler food', 'sizzlershishilexicanting', 'sizzlercantingshoufeibiaozhun']
水木迷城2	['shuimumichengmishitaotuogonglve', 'shuimuminilianxuju']
xizhimenbinguan	['xizhimenbinguan', 'xizhimenbinguandianhua', 'xizhimenbinguanbuduiwaiyingye', 'xizhimenbinguandizhi', 'xizhimenbinguanyuding', 'xizhimenbinguantaojianjiage', 'xizhimenbinguanguanfangwangzhan', 'xizhimenbinguanfujinditiezhan', 'xizhimenbinguan youyong', 'xizhimenbinguanduoshaoqian']
ROUCHUANWANGZONGDIAN	['rouchuanwangzongdianzenmeyang']
tangchaoKTV	['tangchaokaiguohuangshang', 'tangchaokaiguogongchen', 'tangchaokuijia', 'tangchaokuxing', 'tangchaokaiguomingjiang', 'tangchaoktv', 'tangchaokejuzhidu', 'tangchaokaiyuanshengshi', 'tangchaoktv', 'tangchaokaifang']
聚点串吧=交大店	['judianchuanbajiaodadian']
BJSFRBG	['beijingshifurenquzaineigequ', 'banjiashafaruhedabao', 'beijingshunfengrengongkefudianhua', 'beijingshuangfeiruanjianyouxiangongsi', 'beijingshifengrenjizhizaochang', 'beijiaosuofanruheliangxing', 'beijingshoufangrendingbiaozhun', 'beijingshifengruibinguan', 'beijingsafurui尔yingshi']
tpyzq	['taipingyang', 'taipingyangbaoxian', 'taipingyangqichewang', 'taipingyangqiche', 'taipingyangzhanzheng', 'tianpengyuanshuai', 'taipingyangkafei', 'taipingyangchexian', 'taipingyangbaoxiangongsi', 'type']
gymboree	['gymboree']
bianjinggongheguo	['bianjinggongheguo(xin奥dian)', 'bianjinggongheguo dazhongdianping', 'bianjinggongheguocantingcaidan', 'bianjinggongheguo(huijugouwuzhongxin)']
HuXiaoShanZhuang~1F	['huxiaoshanzhuang', 'huxiaoshanzhuangjianjie', 'huxiaoshanzhuangcaiyongshenmexushufangfa', 'huxiaoshanzhuangduhougan', 'huxiaoshanzhuangdianying', 'huxiaoshanzhuangjingdianyulu', 'huxiaoshanzhuangzuozhe', 'huxiaoshanzhuangrenwuguanxitu', 'huxiaoshanzhuanghaocihaoju', 'huxiaoshanzhuangrenwufenxi']
jindingxuan_5g	['jindingxuan', 'jindingxuan二gongzidafan', 'jindingxuancaidan', 'jindingxuan二gongzi', 'jindingxuanditandian', 'jindingxuancaidanjijiage', 'jindingxuanyonghegongdiandizhi', 'jindingxuan24xiaoshiyingye', 'jindingxuantuanjiehudian', 'jindingxuanfangzhuangdiandianhua']
tingyun	['tingyu', 'tingyuan', 'tingyuansheji', 'tingyun', 'tingyouqiaomumaoruxingmianfeiquanshuyuedu', 'tingyinyue', 'tingyungaotie', 'tingyuanshenshen', 'tingyunlieche', 'tingyunchecichaxun']
meishenxuqing5G	['meishenxuqing', 'meishenxuqingyiliaomeirong', 'meishenxuqingmeilamenzhen', 'meishenxuqingzhengxing', 'meishenxuqingmeilamenzhendizhi', 'meishenxuqingmeilamenzhenpian', 'meishenxuqingshengwujiaonianhe', 'meishenxuqingjiehunlema', 'meishenxuqingshuangyanpijiage']
CUPONE	['cuposuannisongpianshishenmeyao', 'cupor', 'cupon', 'cupoyangtou', 'cupolomotuo', 'cuposongnipianzuoyong', 'cupone', 'cupola', 'cuporshenmepaizi']
yuxueyuan	['yuxueyuan', 'yuxueyule', 'yuxueyuledeyisishishenme', 'yuxueyuanappxiazai', 'yuxueyuanhuiyuanzhidema', 'yuxueyuanzhensuo', 'yuxueyuandianhua', 'yuxueyulexiayijushishenme', 'yuxueyuqu', 'yuxueyuqushishenmeyisi']
huashangjiudian	['huashangjiudian', 'huashangjiudianguanliyouxiangongsi', 'huashangjiudian sanyuanqiao', 'huashangjiudian(xiamenwandian)zenmeyang', 'huashangjiudian-zhongcantingzenmeyang', 'huashangjiudiandianhuazhangzhou', 'huashangjiudian(ganhedadao)zenmeyang', 'huashangjiudian-KTVzenmeyang', 'huashangjiudianshiguoqima']
CUPONE-2	['cuponeshenmeyisi']
bjfyxybg	['baojingfeiyongxuyaoduoshaoqian', 'bujianfengyuxiayijushishenme', 'beijingfanyixueyuanshijiben', 'beijingfanyixueyuandefenshuxian', 'beijingfanyixueyuanzenmeyang', 'bujufengyuxiayijushishenme']
beifangyouyicun	['beifangyouyicundianhua', 'beifangyouyicunzenmeyang', 'beifangyouyicunyingyeshijian', 'beifangyouyicunshanghugaikuang', 'beifangyouyicaimingjiaohashenmezhuo', 'beifangyouyicunfarenshishui', 'beifangyouyicunzaixiancaidan']
suzumei	['suzumu', 'suzume', 'suzumushijian', 'suzumefanyi', 'suzumeibeijing', 'suzume shenmepinzhong', 'suzumba', 'suzuma', 'suzumufuchu', 'suzumianmozenmeyang']
@张亮麻辣烫	['zhangliangmalatang', 'zhangliangmalatangshishuikaide', 'zhangliangmalatangjiamengfeiyong', 'zhangliangmalatangjiameng', 'zhangliangmalatangjiamengfeiyongxuyaoduoshaoqian', 'zhangliangmalatangchuangshirenheyangguofu', 'zhangliangmalatanglaobanjiaoshenme', 'zhangliangmalatangguanwang', 'zhangliangmalatangheyangguofuneigehaochi', 'zhangliangmalatangduoshaoqianyijin']
CUPONE-1	['cuponeshenmeyisi']
dizhibinguan	['dizhibinguan', 'dizhibinguandianhua', 'dizhibinguanzuojilugongjiaoche']
helijia-bj	['helijia', 'helijiaguanwang', 'helijiameijiashizhenshishouru', 'helijiazenmeyang', 'helijiakefudianhua', 'helijiangjun', 'helijiaxinshounengjiedaodanma', 'helijiadexianzhuang', 'helijianfeifa', 'helijiaappxiazai']
DAVOST	['dabozibing']
小筑酒店2	['xiaozhujiudian']
黎明园宾馆	['zunhualimingyuan', 'hangzhoulimingyuan', 'beijinglimingyuan']
wanglibank	['wanglibao', 'wanglibaozuixinxiaoxi', 'wanglibaojiaoliuqun', 'wanglibaozuixinxiaoxi2019', 'wanglibaodeqianhainengnahuilaima', 'wanglibaoli案', 'wanglibaoxiangui', 'wanglibaozuixinxiaoxi2019nian6yue', 'wanglibaoappxiazai', 'wanglibaoxinwen']
meishenxuqing	['meishenxuqingyiliaomeirong', 'meishenxuqing', 'meishenxuqingmeilamenzhen', 'meishenxuqingzhengxing']
xibeihanzi	['xibeihangkong', 'xibeihanzi', 'xibeihanzidexinggetedian', 'xibeihangkongdaxue', 'xibeihangtianhangkongdaxue', 'xibeihangkonggongsi', 'xibeihanzicanting', 'xibeixinggonglve', 'xibeihangkonggongsiguanwang', 'xibeihangkong85hao']
helijia	['helijiqun', 'helijia', 'helijiqundeyisi', 'geli', 'helijiqunshishenmeshengxiao', 'heliji', 'helijiaguanwang', 'helijiazenmeyang', 'helijuan', 'helijiangjun']
huajiayiyuan	['huajiayiyuansiheyuan', 'huajiayiyuansijiqingdian', 'huajiayiyuan', 'huajiayiyuanjinrongjiedian', 'huajiayiyuanrongkedian', 'huajiayiyuancaidan', 'huajiayiyuanqinghuaxiludian', 'huajiayiyuanyuanmingyuandian', 'huajiayiyuanhuixindian', 'huajiayiyuandongzhimendian']
Bluche	['bluck', 'bluce', 'blucher', 'bluch', 'bluceshenmeyisi', 'bluckshishenmeyisiyanse', 'bluckche', 'blued', 'blucon', 'blush']
Homeinns	['homeinn', 'homeinnshenmeyisi', 'homeins']
wennuandelvtu	['wennuandelvchengzuowen600zi', 'wennuandelvcheng', 'wennuandelvchengzuowen500zi', 'wennuandelvcheng800zi', 'wennuandelvchengzuowen800zi', 'wennuandelvxing600zizuowen', 'wennuandelvcheng700zi', 'wennuandelvchengzuowen450zi', 'wennuandelvcheng600zi', 'wennuandelvchengzuowenkaitou']
lanhuhui	['lanhuhui', 'lanhuhuivipgongguan', 'lanhuhuanbaokejiyouxiangongsi', 'lanhuhuivipgongguan 2000duo', 'lanhuhuishijiwenquanhuisuo', 'lanhuhaoyangma', 'lanhuhexuehuneigehaoyang', 'lanhuhu', 'lanhuhansanquanji', 'lanhuhu']
wanglaoliu	['wanglaoliu', 'wanglaoliutieguodunyu', 'wanglaoliushuochanggeci', 'wanglaoliuzenmebugengxinle', 'wanglaoliudeshuochangbgm', 'wanglaoliudajieshangshoulounenmo', 'wanglaolv,guihua', 'wanglaoliutieguodunyuchuangshiren', 'wanglaolichuangzuodeyuansheng', 'wanglaoliutaobaodianjiaoshenme']
shikongtang	['shikongta', 'shikongtaiyunhuikui', 'shikongtaoxunzhifa', 'shikongtaodizhifa', 'shikongtaoxunzenmechuixiang', 'shikongtaosha xiaoshuo', 'shikongtaodizhifashipin', 'shikongtaiyang8gong', 'shikongtanyuantianfu']
salahuaer	['salahua儿xiyumeishi', 'salahua儿', 'salahua儿shishenmeyisi', 'salahua儿taiyanggongdianhua', 'salahua儿taiyanggong', 'salahua儿yayuncundiandianhua', 'salahuafandian', 'salahuashishenmeyisi', 'salahuashishenmehua', 'salahua']
beiwaiqingshao	['beiwaiqingshao', 'beiwaiqingshaoyingyu', 'beiwaiqingshaoyingyuxiaoqu', 'beiwaiqingshaoyingyuxiaoqudianhua', 'beiwaiqingshaoxiaoqu', 'beiwaiqingshaoguanwang', 'beiwaiqingshaoyingyupeixunzhongxinzenmeyang', 'beiwaiqingshaoyingyuapp安zhuo', 'beiwaiqingshaoyingyuguanwangpingtai', 'beiwaiqingshaoyingyufeiyong']
muwushaokao	['muwushaokao', 'muwushaokaodian', 'muwushaokaojidianhaixianbanjia', 'muwushaokaoguanwang', 'muwushaokaocaidan', 'muwushaokaoyingyeshijian', 'muwushaokaolaoban', 'muwushaokaojiamengfeiduoshao', 'muwushaokaochuangshiren']
4008190099	['4008190099']
menggongfang	['menggongfang', 'menggongfangkafeiba', 'menggongfangyingcheng', 'menggongfangapp', 'menggongfangkafei', 'menggongfangyingchengcaitang', 'menggongfangyingchengzaixiamennali', 'menggongfangkafeiyingyeshijian', 'menggongfangyouhuiquanzenmeyong']
saboten	['sabotage', 'saboteur', 'saboten', 'sabotageshishenmeyisi', 'saboteurzhuoyouguize', 'sabotupian', 'sabotouxiang', 'sabotupiangaoqinghaizeiwang', 'sabotanda', 'sabotingdao艾sisixunshinayiji']
qiaobamei	['pucanlie', 'qiaobamuzhuangjia', 'pubaoying', 'pubaojian', 'qiaobamufuhezhuangjia', 'qiaobamaozishangdechiyushishenmeyisi', 'qiaobamengtu', 'qiaobamaozi', 'qiaobamu', 'qiaobamingyan']
@机场巴士	['jichangdabashikebiao', 'jichangdaba', 'jichangtingcheduoshaoqianyitian', 'jichangtuoyunxinglizenmeshoufei', 'jichangtuoyunxingliguiding', 'jichangt1t2t3shishenmeyisi', 'jichangxianshoumocheshijian', 'jichang安jianyuangongzidaiyu', 'jichangdabaluxian', 'jichangdiqinshizuoshenmede']
shenmimei	['shenmimoce', 'shenmimaxituan', 'shenmimamicongtianjiangmianfeiyuedu', 'shenmimianjunan', 'shenmimamacongtianjiangquanwenmianfeiyuedu', 'shenmimoshaotianjiaoqi', 'shenmimamicongtianjiangmianfeiyueduwuguanggao', 'shenmimianjunanshishui', 'shenmimianjunanqianrumuyezhaohuanjiuwei']
城市之光6	['chengshizhiguang', 'chengshizhichuang', 'chengshizhixing', 'chengshizhijian', 'chengshizhijia', 'chengshizhiyin', 'chengshizhixin', 'chengshizhiguangdongwang', 'chengshizhisheng', 'chengshizhixingwuliudanhaochaxun']
chanzuimao	['chanzuimao', 'chanzuimaojiameng', 'chanzuimaolingshijiameng', 'chanzuimaotupian', 'chanzuimiaomiao xiguashipin', 'chanzuimiaomiaozuixinshipin', 'chanzuimalatang', 'chanzuimaochuanba', 'chanzuimaochuanchuanxiang', 'chanzuimalatangjiamengfei']
lanzhoulamian	['lanzhoulamian', 'lanzhoulamiancaidan', 'lanzhoulamiandezuofa', 'lanzhoulamianshineigeminzu', 'lanzhoulamiantangliaopeifangdan', 'lanzhoulamiantupian', 'lanzhoulamianpaihangbang', 'lanzhoulamianweishenmeburanghejiu', 'lanzhoulamianreliang', 'lanzhoulamiandemianzenmehuomian']
yuzhiguang	['yuzhiguanzhuang', 'yuzhiguahuanbaiduyun', 'yuzhiguanzhuangyanshouguifanbiaozhun', 'yuzhiguang', 'yuzhiguangzhengxingmeirong', 'yuzhiguanzhuangshigongkongzhiyaodian', 'yuzhiguangdagonglvdianba', 'yuzhiguang', 'yuzhiguanzhuangjiage']
wangsteak	['wangsteampingtaifayouxi']
xespy	['xess', 'xue而si', 'xing而shangxue', 'xue而siwangxiao', 'cesu', 'sex', 'xue而siwangxiaozenmeyang', 'xiu儿shishenmeyisi', 'xue而sidianhua']
nanmensijishuanrou	['nanmensijishuanrou', 'nanmensijishuanrouyayuncundian', 'nanmensijishuanrouzuojiazhuangdian', 'nanmensijishuanrouzenmeyang', 'nanmensijishuanrou(shaoyaojubeilidian)zenmeyang', 'nanmensijishuanrou(wukesongdian)zenmeyang', 'nanmensijishuanrou lishuiqiao', 'nanmensijishuanrouwukesongdian', 'nanmensijishuanrou(yayuncundian)shanghugaikuang']
又一湘二楼	['youyixiang huixindong', 'youyixiangwangjingdian', 'youyixiangwangjing']
chuanshifengge	['chuanshifengzheng', 'chuanshifengzhengtupiandaquan', 'chuanshifengzhengjianbihua', 'chuanshifengjing二shoufangchushou', 'chuanshifenghaowangjueshengjibiao', 'chuanshifengchezenme安zhuang', 'chuanshifengtupian', 'chuanshifengchezenme安zhuangtujie', 'chuanshifengbaozhendezhitongfengma', 'chuanshifengjingyou儿yuanzenmeyang']
HUAZHU-Hanting.	['huazhuhantingjiudianwifimima', 'huazhuhanting', 'huazhuhantingjiudian', 'huazhuhantingguanwang', 'huazhuhantingningbo', 'huazhuhantingjiudianshujuxielou', 'huazhuhantingwifimimarenzheng', 'huazhuhantingsuofeiya', 'huazhuhantingdemimashishenme', 'huazhuhantingdianhuashiduoshao']
hongxizu	['hongxiutianxiang', 'hongxiuquan', 'hongxibao', 'hongxiuzhu', 'hongxi', 'hongxingmeikailong', 'hongxingshanyaopingjia', 'hongxiu', 'hongxingzhaoyaozhongguo', 'hongxinhuolongguo']
tuojiangxiaozhen	['tuojiangxiaozhen', 'tuojiangxiaozhenduiwaijingmaodaxue', 'tuojiangxiaozhencanyinguanliyouxiangongsi', 'tuojiangxiaozhen(安zhendian)shanghugaikuang']
动感易带网吧	['dongganyidaiwangbazenmeyang', 'dongganyidaiwangkazenmeyang']
sinopec	['sinopec', 'sinopecshishenmeyisi', 'sinopay', 'sinopac', 'sinopecsales.co m', 'sinopecquancheng', 'sinope', 'sinoped', 'sinophile', 'sinoppe']
伊藤洋华堂亚运村店	['yitengyanghuatangyayuncundian', 'yitengyanghuatangyayuncunyingyeshijian', 'yitengyanghuatangyayuncundiantuihuanhuo', 'yitengyanghuatangyayuncundian1louxinkaihuazhuangpinshenmepaizi', 'yitengyanghuatangyayuncundiandianhua']
Yitel	['yitiantulongji', 'yitaifang', 'yitailiangbaolaopodarenbiexiangtao', 'yitian', 'yitengrun二', 'yitiaoxiaotuantuan', 'yitianhe8beinaicha', 'yitailiangbao laopodarenbiexiangtao', 'yitaishuangbaozongcaidarenyeyehuan', 'yitiaogoudeshiming2']
Atour	['atom', '阿tongmu', 'atop', 'atmos', 'atos', 'atomy', 'atoi', 'auto', 'atomjiasuqi']
@秦风渝味	['qinfengbingwang', 'qinfengyishibingwang', 'qinfengxiaoshuomianfeiquanwenyuedu', 'qinfengwang', 'qinfengwuyiyuanwen', 'qinfengxiaoshuo', 'qinfengbingwangxiaoshuo', 'qinfengbingwangzhujuedexiaoshuo', 'qinfengjianjiaquanwenzhupinyin']
城市之光3	['chengshizhiguang', 'chengshizhichuang', 'chengshizhixing', 'chengshizhijian', 'chengshizhijia', 'chengshizhiyin', 'chengshizhixin', 'chengshizhiguangdongwang', 'chengshizhisheng', 'chengshizhixingwuliudanhaochaxun']
bengeshousi	['bengeshousi', 'bengeshousi beijing', 'bengeshousi hangzhou']
bibichi	['bibicar', 'bibizan', 'bibizanzenmejiedong', 'bibizanshishenmeyisi', 'bibizanzenmequxiao', 'bibizanshenmeyisi', 'bibizandeqianzenmequchulai', 'bibizanquchudeqianzainali', 'bibizanzenmequchulai', 'bibizandongjiejin额nengquma']
@茶花妹子过桥米线	['chahuameiziguoqiaomixian', 'chahuameiziguoqiaomixianzenmeyang', 'chahuameiziguoqiaomixiandi安men1dianzenmeyang', 'chahuameiziguoqiaomixian(di安men1dian)zenmeyang', 'chahuameiziguoqiaomixian beijing']
五指生亚运村店	['wuzhishengyayuncundian', 'wuzhishengyayuncundiandianhua', 'wuzhishengyayuncundiantupian', 'wuzhishengyayuncunyingyeshijian', 'wuzhishengyayuncundianjiamubiao', 'wuzhishengyayuncundian zhaozongjian', 'wuzhishengyayuncundiannvjishi', 'wuzhishengyayuncundianxiujiaoshi']
城市之光5	['chengshizhiguang', 'chengshizhichuang', 'chengshizhixing', 'chengshizhijian', 'chengshizhijia', 'chengshizhiyin', 'chengshizhixin', 'chengshizhiguangdongwang', 'chengshizhisheng', 'chengshizhixingwuliudanhaochaxun']
便宜坊03	['pianyifangkaoya', 'pianyifangkaoyaduoshaoqianyizhi', 'pianyifangzenmedu', 'pianyifangkaoyahequanjudekaoyadequbie', 'pianyifangkaoyadian', 'pianyifangzongdian', 'pianyifangdianhua', 'pianyifangjituan', 'jinanpianyifang', 'pianyifangzhuchu']
dechuanjia	['dechuanjiakang', 'dechuanjia', 'dechuanjiaguang', 'dechuanjizong', 'dechuanjiariliao', 'dechuanjiakangrenwuguanxitu', 'dechuanjiamao', 'dechuanjiakangquanjizaixianyuedu', 'dechuanjiazu', 'dechuanjiakangmingyan']
diguashequ	['diguashenmeshihouchengshu', 'diguashengyahainengchima', 'diguashequ', 'diguashenmeshihouzhong', 'diguashenmeshihoufanyang', 'diguashenmeshihouchuanruzhongguo', 'diguashengchiyoushenmehaochu', 'diguashengzhangqiduoshaotian', 'diguashengyazinengchima', 'diguashequguanwang']
交通银行信用卡	['jiaotongyinhangxinyongkadianhua', 'jiaotongyinhang', 'jiaotongyinhangxinyongkazhongxin', 'jiaotongyinhangxinyongkashenqing', 'jiaotongyinhangdianhua', 'jiaotongyinhangxinyongkaapp', 'jiaotongyinhangxinyongka额du', 'jiaotongyinhangxinyongkakefu', 'jiaotongyinhangxinyongkazhuxiao', 'jiaotongyinhangxinyongkazenmeyang']
shigehuntun	['shigehuntunchabuduoduoshaoke', 'shigehuntundereliang', 'shigehuntun', 'shigehuntunmentoutupian', 'shigehuntundereliangduoshao']
味多美安慧东里店	['weiduomei安huidonglidian']
mengjizhoupu	['mengjizhoupu']
zhangliangmalatang	['zhangliangmalatang', 'zhangliangmalatangshishuikaide', 'zhangliangmalatangjiamengfeiyong', 'zhangliangmalatangjiameng', 'zhangliangmalatangjiamengfeiyongxuyaoduoshaoqian', 'zhangliangmalatangchuangshirenheyangguofu', 'zhangliangmalatangguanwang', 'zhangliangmalatanglaobanjiaoshenme', 'zhangliangmalatangbaidubaike', 'zhangliangmalatangshenmegeng']
zixiamen	['zixiamen', 'zixiamiandehengxianzenmeda', 'zixiamianyigezishishenmezi', 'zixiamiji', 'zixiamianyigemu', 'zixiamijibeishuitoule', 'zixiamianzenmejiahengxian', 'zixiamen wangjing', 'zixiamianzenmejiadian', 'zixiamiandehongsebolangxianzenmequdiao']
金草帽炭火烤肉店	['jincaomaotanhuokaorou', 'jincaomaotanhuokaorou(dongwutiaolufujin)zenmeyang', 'jincaomaotanhuokaorouzenmeyang']
Barsak	['barsshishenmeyisi', 'barsliaoyupianju', 'barsh', 'barshishenmeyisi', 'barsliaoyu', 'barstow', 'barshshoubiao', 'barstool', 'barshishenmedanwei', 'bershka']
坦坦大炉望京店1	['tantandaluwangjingdian', 'tantandaluwangjingdianzenmezou', 'tantandaluwangjingdian tuangou', 'tantandaluwangjingdianjiage', 'tantandaluwangjingkaoroudian', 'tantandaluwangjingdianzuoshenmeche', 'tantandaluwangjingdianhua']
cafebene	['cafebeizi']
zhangshifu	['zhangshi', 'zhangshizhao', 'zhangshicheng', 'zhangshihao', 'zhangshishuaifu', 'zhangshiyan', 'zhangshi', 'zhangshiping', 'zhangshihao', 'changshi']
kaximu	['kaxi欧', 'kaxi欧guanwang', 'kaxi欧shoubiao', 'kaxi欧shoubiaozenmetiaoshijian', 'kaximoduo', 'kaxiliyasi', 'kaxi欧heijin', 'kaxi', 'kaxi尔', 'kaxini']
MINGTAIYU1	['mingtaiyu', 'mingtaiyugandezuofadaquan', 'mingtaiyudundoufu', 'mingtaiyutang', 'mingtaiyugan', 'mingtaiyushishenmeyu', 'mingtaiyudezuofa', 'mingtaiyushihaiyuma', 'mingtaiyureliang', 'mingtaiyuhexueyudequbie']
裕食坊私家湘菜	['yushifangsijiaxiangcaizenmeyang', 'yushifangsijiaxiangcaibaolidian']
MAZHA-JIUWU	['mazhajiushihuangchongma', 'mazhajiushitanglangma', 'mazhajiushiguoguoma', 'mazhajiuwu', 'mazhajiudegongxiaoyujinji', 'mazhajiudegongxiao', 'mazhajiuzenyangpao', 'mazhajiu']
RYSWJD	['rongyuanshiwawayuma', 'ruoyousuowuderuoshishenmeyisi', 'rongyaoshiweipingbandiannaozenmeyang', 'riyishengweibo', 'rongyaoshiweishenmelabuxialai', 'renyuanshangwangchengduhuafen', 'riyushangwushuipingshijiji', 'renyousanwanmiannanchi', 'riyushiwuyu', 'ruoyousuowu']
huohuozhuti	['huohuozhu', 'huohuozhuzhudeyisi', 'huohuozhuoyizhimafanjing']
TOMNTOMSCOFFEE1	['tomntomscoffeezhongwenjiaoshenme', 'tomntomscoffee(longhushidaitianjiedian)zenmeyang']
lazhuang	['lazhua', 'lazhuang', 'nezha', 'lazhuanghuoguo', 'lazhuashenmeyisi', 'lazhuangshibaobei尔kaidema', 'lazhu啊shenmegeng', 'lazhao', 'lazhuashishenmeyisi啊', 'lazhuangjiamengfei']
Tianfujiachangcai	['tianfujiachangcaicanguanzenmeyang', 'tianfujiachangcaiguan(furongxiangdian)zenmeyang', 'tianfujiachangcaiguanzenmeyang', 'tianfujiachangcaiguanzhou·shuijiaochengzenmeyang']
warawara	['haniwawawawa']
CupOne_5G	['cuponeshenmeyisi']
maxen	['maxus', 'maxmara', 'maxshenmeyisi', 'maximum', 'max+', 'may', 'maya', 'maxzenmedu', 'imac']
JinYongKTV	['jinyongkapaishouyou', 'jinyongkongtiaodeguojia', 'jinyongkatongpindaozaixianzhibo', 'jinyongkaijiqidongxiang', 'jinyongkezhan', 'jinyongkang', 'jinyongkuaisuqidong', 'jinyongkangsisi']
熔时FIRESIDE	['rongshifiresidelaobanshishui', 'rongshifiresidepingjia', 'rongshifiresidejiameng', 'rongshifiresidelaoban', 'rongshifiresideguanwang', 'rongshifiresideliansuo']
MINGTAIYU2	['mingtaiyu', 'mingtaiyugandezuofadaquan', 'mingtaiyudundoufu', 'mingtaiyutang', 'mingtaiyugan', 'mingtaiyushishenmeyu', 'mingtaiyudezuofa', 'mingtaiyushihaiyuma', 'mingtaiyureliang', 'mingtaiyuhexueyudequbie']
lvhezi	['lvhejin', 'lvhejinmenchuang', 'lvhejinmen', 'lvhezi', 'lvhejinmidu', 'lvhegu', 'lvhejinxingcai', 'lvheqingyanghuanafanying', 'lvheshashou', 'lvhejinhanjie']
TanTanDaLu	['tantandangdang', 'tantandalu', 'tantandangdangshenmeyisi', 'tantandangdangzuoren,tatashishizuoshi', 'tantandashankaichangbai', 'tantandangdangzuorendejuzi', 'tantandazhaohudiyiju', 'tantandangdangshuochunaliugezi', 'tantandanjian', 'tantandazhaohu']
CupOne	['cupola', 'cupon', 'cupor', 'cupone', 'cuposuannisongpianshishenmeyao', 'cupoyangtou', 'cuposongnipianzuoyong', 'cuporshenmepaizi', 'cupolomotuo']
四季民福wifi	['sijiminfuwifimima']
Wanrongxiaochu	['wanrongxiaochu', 'wanrongxiaochiyitiaojiezaina', 'wanrongxiaocheng', 'wanrongxiaochu wangjing', 'wanrongxiaochengshengtaiyaodongzhusuzenmeyang', 'wanrongxiaochushanghugaikuang', 'wanrongxiaochijiezainali', 'wanrongxiaochengyaodongshengtaiyuanjiudianzenmeyang', 'wanrongxiaochiqiaomaihelezuofa', 'wanrongxiaochengjiayandianhua']
yiruntang	['yiruntangwangjingdian', 'yiruntangdaxiyangxinchengdian', 'yiruntangguofeng', 'yiruntangzhengguima', 'yiruntang按mozenmeyang', 'yiruntangwudaokou taocan', 'yiruntangchenpi', 'yiruntangzenmeyang']
剪艺人生－中福	['jianyirenshengwangjingzhongfudian', 'jianyirenshengwangjing', 'jianyirenshenghuacaidiandianhua', 'jianyirenshenglifadianzenmeyang', 'jianyirenshengzenmeyang', 'jianyirenshengwangjingxiadoudian', 'jianyirenshengximenzi', 'jianyirenshengjiangtailudian', 'jianyirenshengxianzaishenmejiawei', 'jianyirensheng jiage']
huangtucheng	['huangtuchengyu', 'huangtuchen埃yixiaoduncaiyixiao', 'huangtuchengyu', 'huangtuchengfen', 'huangtucheng', 'huangtuchen埃', 'huangtuchengyinliudongsheng', 'huangtuchenxiangduoshaoqianyike', 'huangtuchengdaoyanqing', 'huangtuchenxiangshouchuanjiage']
hongjingyu	['hongjing', 'hongjingtian', 'hongjingtiandegongxiaoyuzuoyong', 'hongjing3', 'hongjingol', 'hongjing2', 'hongjingkuaijiejian', 'hongjingzhijia', 'hongjinbao', 'hongjingtianjiaonang']
yesido	['yesi', 'tesila', 'yesir', 'yesu', 'yesidofanyizhongwen', 'yezi', 'yesidozhongwenshishenmeyisi', 'yesiymh', 'yesi', 'yesiam']
辉佐参鸡汤	['huizuocanjitang']
京朋串屋老店	['jingpengchuanwuweishenmenamehuo', 'jingpengchuanwuzongdian', 'jingpengchuanwu2haodian', 'jingpengchuanwu(2haodian)zenmeyang', 'jingpengchuanwu(zongdian)zenmeyang', 'jingpengchuanwu(wangjingditiezhandian)zenmeyang', 'jingpengchuanwu(wanshouqiaodian)zenmeyang', 'jingpengchuanwu(wanshouqiaodian)shanghugaikuang', 'jingpengchuanwu(haidian3dian)zenmeyang']
HanTing	['hantian', 'hantianyu', 'hanting', 'hantingjiudian', 'hantianzi', 'hantiandi', 'hantiegaodeshiwu', 'hantianlei', 'hantiao', 'hantiantianchanggeshipin']
寂寞的豆芽	['jimodeshaofudeyouhuo', 'jimodejijie', 'jimodenvren', 'jimodefanyici', 'jimodejinyici', 'jimodeyisi', 'jimodewuzhe nvzongcaidequannengbingwang', 'jimodeye', 'jimoderenshangxindege', 'jimodepinyin']
yixuanjiaozi	['yixuanjiaoziguan', 'yixuanjiaoyu', 'yixuanjiaonibengdi20', 'yixuanjiaonibengdiquandiyiji', 'yixuanjiaonibengdi二', 'yixuanjiaoziguanlidudian', 'yixuanjiaozilidu', 'yixuanjiaonibengdi15', 'yixuanjiaonibengdi二shiliu', 'yixuanjiaonibengdiyi']
BARSAK1	['barsac', 'barsacguifujiu', 'barsark', 'barsan', 'bao安renshen安quantiaoli', 'bao安renshen安quanzhishipeixun']
Baihualin	['baihualin', 'baihualou', 'baihualiaoluan', 'baihualingeci', 'baihualinjingqu', 'baihualinxi', 'baihualinmingtian', 'baihualinjitapu', 'baihualintupian', 'baihualinjian']
@辉佐参鸡汤	['huizuocanjitang']
qihuannuanwu	['qihuannuannuangongzhutupian', 'qihuannuannuantupiandaquan']
火齐潮汕砂锅粥	['huoqichaoshanshaguozhoucaidan', 'huoqichaoshanshaguozhouzenmeyang', 'huoqichaoshanshaguozhou(guomaodian)zenmeyang', 'huoqichaoshanshaguozhou(muxiyuandian)zenmeyang', 'huoqichaoshanshaguozhou(heshenghuidian)zenmeyang', 'huoqichaoshanshaguozhoujiamubiao', 'huoqichaoshanshaguozhou(taiyanggongkaidedian)zenmeyang', 'huoqichaoshanshaguozhoujiamengfei', 'huoqichaoshanshaguozhou(ciyunsidian)zenmeyang']
sijiminfu	['sijiminfu', 'sijiminfukaoyadian', 'sijiminfugugongdian', 'sijiminfukaoya', 'sijiminfukaoyadianyuyue', 'sijimingdian', 'sijiminfukaoyadianbidiancai', 'sijiminfucaidanjiagebiao', 'sijiminfukaoyaduoqianyizhi', 'sijiminfukaoyadiangugongdian']
xiaoshiguangmang	['xiaoshiguangmang', 'xiaoshiguangmanyifenfang', 'xiaoshiguangmangglovayoushou', 'xiaoshiguangmang2', 'xiaoshiguangmang2shenmeshihouchu', 'xiaoshiguangmaomikafeiguan', 'xiaoshiguangmangzenmecainenglianji', 'xiaoshiguangmaojiaoyinxiao', 'xiaoshiguangmalatangzenmeyang', 'xiaoshiguangmanbuxiangshui']
黄门老灶火锅	['huangmenlaozaohuoguo', 'huangmenlaozaohuoguoguanfangwangzhan', 'huangmenlaozaohuoguoguibugui', 'huangmenlaozaohuoguofendian', 'huangmenlaozaohuoguo(landianchangdian)zenmeyang', 'huangmenlaozaohuoguo(huanyakaiselinguangchangdian)zenmeyang', 'huangmenlaozaohuoguohaochima', 'huangmenlaozaohuoguo(xianlindaxuechengdian)zenmeyang', 'huangmenlaozaohuoguo(奥sikadian)zenmeyang', 'huangmenlaozaohuoguo(shifoyingdian)zenmeyang']
友佳超市2	['youjiachaoshi']
新天地KTV	['xintiandikaifashang', 'xintiandik11', 'xintiandik11shishenmedifang', 'xintiandiktvjiage恩shi', 'xintiandiktvmentouzhao', 'xintiandikuamaoxiaozhen', 'xintiandikejiyouxiangongsi', 'xintiandikefulianxifangshi', 'xintiandikeyijicunxinglima', 'xintiandikendeji']
duolezhiri	['duolezhiri', 'duolezhiriguanwang', 'duolezhiridangao', 'duolezhirijiamengfeiduoshaoqian', 'duolezhiridangaodinggou', 'duolezhiridangaojiagebiao', 'duolezhirizhaopin', 'duolezhirimianbao', 'duolezhirishinalidepinpai', 'duolezhirizenmeyang']
剪艺人生-夏都	['jianyirenshengwangjingzhongfudian', 'jianyirenshengwangjing', 'jianyirenshenghuacaidiandianhua', 'jianyirenshenglifadianzenmeyang', 'jianyirenshengzenmeyang', 'jianyirenshengwangjingxiadoudian', 'jianyirenshengximenzi', 'jianyirenshengjiangtailudian', 'jianyirenshengxianzaishenmejiawei', 'jianyirensheng jiage']
pangzilongxia5	['pangzilongxia', 'pangzilongxiamajiabaodian', 'pangzilongxiasongjiazhuangdian', 'pangzilongxiashijingshandiandianhua', 'pangzilongxiawangjingdian', 'pangzilongxiashijingshandian', 'pangzilongxiawanfengludian', 'pangzilongxialiao', 'pangzilongxiahaixianshaokaojiameng', 'pangzilongxiazuoliao']
MrPIZZA	['mrpizza', 'mrpizzashishenmepinpai', 'mrpizzaguanwang', 'mrpizzahebishengke', 'mrpizzajiamengfeiduoshaoqian', 'mrpizzashinalide', 'mrpizzahaochima', 'mrpizzajiamengfei', 'mrpizzatousudianhua', 'mrpizzacaidanjijiage']
kangyunyangsheng	['kangyunyangshengtang', 'kangyunyangshenghuiguanzhengguima', 'kangyunyangshenghuiguanshilihe', 'kangyunyangshenghuiguan gaikuang', 'kangyunyangshenghuisuozenmeyang', 'kangyunyangshenghuiguan pinglun', 'kangyunyangshenghuisuo wangjing']
多乐之日望京SOHO店	['duolezhiriwangjingsohoneigemianbaohaochi']
一个叫川的地方	['yigejiaochuandedifangbeijing', 'yigejiaochuandedifangguanwang', 'yigejiaochuandedifangnanchang', 'yigejiaochuandedifangshuikaide', 'yigejiaochuandedifangcanting', 'yigejiaochuandedifang gaikuang', 'yigejiaochuandedifang68zhehuodongzenmesuande']
路边烤牛肉	['lubiankaoyaweishenmezhemepianyi', 'lubiankaochuandouyousha', 'lubiankaojitouziduoshao', 'lubiankaojijiazhengqianma', 'lubiankaochuantupian', 'lubiankaoji', 'lubiankaojidezuofashipin', 'lubiankaoroushishenmerou', 'lubiankaoyatuijitui', 'lubiankaochuanzhi癌']
zhuluchalou	['zhuluchalouxueyuanludian', 'zhuluchalou', 'zhuluchalouxizhimendian', 'zhuluchalouwangjing', 'zhuluchalouzhichunludian', 'zhuluchaloumingguangqiaodian', 'zhuluchaloululiudaokou', 'zhuluchalouguizuhuizhengguima', 'zhuluchalouzhichunlu']
TOMNTOMSCOFFEE	['tomntomscoffeezhongwenjiaoshenme', 'tomntomscoffee(longhushidaitianjiedian)zenmeyang']
WARAWARA	['haniwawawawa']
